60
40
090010010900100209001001090010020900100109001002090010010900100209001001090010020900100109001002090010010900100209001001090010020900100109001002090010010900100209001001090010020900100109001002090010010900100209001001090010020900100109001002090010010900100209001001090010020900100109001002090010010900100209001001090010020900100109001002090010010900100209001001090010020900100109001002090010010900100209001001090010020900100109001002090010010900100209001001090010020900100109001002
090020010900200209002001090020020900200109002002090020010900200209002001090020020900200109002002090020010900200209002001090020020900200109002002090020010900200209002001090020020900200109002002090020010900200209002001090020020900200109002002090020010900200209002001090020020900200109002002090020010900200209002001090020020900200109002002090020010900200209002001090020020900200109002002090020010900200209002001090020020900200109002002090020010900200209002001090020020900200109002002
090010010900100209003001090030020900300109003002090030010900300209003001090030020900300109003002090030010900300209003001090030020900300109003002090030010900300209003001090030020900300109003002090030010900300209003001090030020900300109003002090030010900300209003001090030020900300109003002090030010900300209003001090030020900300109003002090030010900300209003001090030020900300109003002090030010900300209003001090030020900300109003002090030010900300209001001090010020900100109001002
090020010900200209004001090040020900400109004002090040010900400209004001090040020900400109004002090040010900400209004001090040020900400109004002090040010900400209004001090040020900400109004002090040010900400209004001090040020900400109004002090040010900400209004001090040020900400109004002090040010900400209004001090040020900400109004002090040010900400209004001090040020900400109004002090040010900400209004001090040020900400109004002090040010900400209002001090020020900200109002002
09001001090010020900100309001004020-10-1020-10-1040890320408903304089034040890350408903604089037040890380408903904089040020-10-1020-10-1020-10-1020-10-1020-10-10200600702006007020-10-1020-10-10200600702006007020-10-1020-10-1000040220000402300004024020-10-1020-10-1020-10-1020-10-1020-10-1020-10-1020-10-1020-10-1020-10-1020-10-1020-10-1020-10-1020-10-1000150150001501600015017020-10-1020-10-1020-10-1020-10-1020-10-1020-10-1020-10-1020-10-1020-10-109001001090010020900100109001002
09002001090020020900200309002004020-10-1020-10-1040900320409003304090034020-10-1020-10-1020-10-104090038020-10-104090040020-10-1020-10-1020-10-1020-10-1020-10-10200700702007007020-10-1020-10-10200700702007007020-10-10000502100005022000050230000502400005025020-10-1020-10-10000401500004016020-10-1020-10-1020-10-10001702300017024020-10-1020-10-10001601400016015000160160001601700016018020-10-1020-10-1020-10-1020-10-1020-10-1020-10-1020-10-1020-10-109002001090020020900200109002002
09001001090010020900100309001004020-10-1020-10-104091032020-10-104091034020-10-1020-10-1020-10-104091038020-10-104091040020-10-1020-10-1020-10-1020-10-1020-10-10200700702007007020-10-1020-10-102007007020070070000602000006021000060220000602300006024000060250000602600005014000050150000501600005017020-10-10001802200018023000180240001802500017013000170140001701500017016000170170001701800017019020-10-1020-10-1020-10-1020-10-1020-10-1020-10-1020-10-109001001090010020900100109001002
09002001090020020900200309002004020-10-1020-10-1020-10-104092033040920340409203504092036040920370409203804092039020-10-1020-10-1020-10-1020-10-1020-10-1020-10-1020-10-1020-10-1020-10-1020-10-1020-10-1020-10-10000702000007021000070220000702300007024000070250000702600006014000060150000601600006017020-10-10001902200019023000190240001902500018013000180140001801500018016000180170001801800018019020-10-1020-10-1020-10-1020-10-1020-10-1020-10-1020-10-109002001090020020900200109002002
09001001090010020900100309001004020-10-1020-10-104093032020-10-104093034020-10-1020-10-1020-10-104093038020-10-104093040020-10-1020-10-1020-10-1020-10-1020-10-1020-10-1020-10-1020-10-1020-10-1020-10-1020-10-1000080200000802100008022020-10-100008024000080250000802600007014000070150000701600007017020-10-100020022000200230002002400020025000190130001901400019015020-10-1000190170001901800019019020-10-1020-10-1020-10-1020-10-1020-10-1020-10-1020-10-109001001090010020900100109001002
09002001090020020900200309002004020-10-1020-10-104094032020-10-104094034020-10-1020-10-1020-10-104094038020-10-104094040020-10-1020-10-1020-10-1020-10-1020-10-1020-10-1020-10-1020-10-1020-10-1020-10-1020-10-10000902000009021020-10-1020-10-1020-10-10000902500009026020-10-1020-10-1020-10-1020-10-1020-10-1020-10-1020-10-1020-10-1020-10-10002001300020014020-10-1020-10-1020-10-10002001800020019020-10-1020-10-1020-10-1020-10-1020-10-1020-10-1020-10-109002001090020020900200109002002
09001001090010020900100309001004020-10-1020-10-1020-10-10409503304095034040950350409503604095037040950380409503904095040020-10-10002005100020052020-10-1020-10-1020-10-1020-10-1020-10-1020-10-1020-10-1020-10-1020-10-1020-10-1020-10-1020-10-1020-10-1020-10-1020-10-100010014020-10-1020-10-1020-10-1020-10-1020-10-1020-10-1020-10-1020-10-1020-10-1020-10-1020-10-1020-10-1020-10-1020-10-1020-10-1020-10-1020-10-1020-10-1020-10-1020-10-1020-10-1020-10-109001001090010020900100109001002
09002001090020020900200309002004020-10-1020-10-1040960320409603304096034020-10-1020-10-1020-10-1040960380409603904096040020-10-1020-10-1020-10-1020-10-1020-10-1020-10-1020-10-1020-10-1020-10-1020-10-1020-10-10000400100004002000040030000400400004005020-10-1020-10-1020-10-1020-10-1020-10-1020-10-1020-10-1020-10-1020-10-1020-10-1020-10-1020-10-1020-10-1020-10-1020-10-1020-10-1020-10-1020-10-1020-10-1020-10-1020-10-1020-10-1020-10-1020-10-1020-10-109002001090020020900200109002002
09001001090010020900100309001004020-10-1020-10-104097032020-10-1020-10-1020-10-1020-10-1020-10-1020-10-1020-10-104097040020-10-1000-10-1020-10-1020-10-1020-10-1020-10-1020-10-1020-10-1020-10-1020-10-1020-10-10000500100005002000050030000500400005005020-10-100004008000040090000401000004011020-10-1020-10-1020-10-1020-10-1020-10-1020-10-1020-10-1020-10-1020-10-1020-10-1020-10-1020-10-1020-10-1020-10-1020-10-1020-10-1020-10-1020-10-1020-10-1020-10-109001001090010020900100109001002
09002001090020020900200309002004020-10-1020-10-1020-10-1020-10-1020-10-1020-10-1020-10-1020-10-1020-10-1020-10-1020-10-1020-10-1020-10-1020-10-1020-10-1020-10-1020-10-1020-10-1020-10-1020-10-1020-10-1020-10-10000600100006002000060030000600400006005020-10-100005008000050090000501000005011020-10-1020-10-1020-10-1020-10-1020-10-1020-10-1020-10-1020-10-1020-10-1020-10-1020-10-1020-10-1020-10-1020-10-1020-10-1020-10-1020-10-1020-10-1020-10-1020-10-109002001090020020900200109002002
09003001090030020900300309003004020-10-1020-10-1020-10-1020-10-1020-10-1020-10-1020-10-1020-10-1020-10-1020-10-1020-10-1020-10-1020-10-1020-10-1020-10-1020-10-1020-10-1020-10-1020-10-1020-10-1020-10-1020-10-10000700100007002000070030000700400007005020-10-100006008000060090000601000006011020-10-1020-10-1020-10-1020-10-1020-10-1020-10-1020-10-1020-10-1020-10-1020-10-1020-10-1020-10-1020-10-1020-10-1020-10-1020-10-1020-10-1020-10-1020-10-10900300009003001090030020900300109003002
09004001090040020900400309004004020-10-1020-10-1020-10-1020-10-1020-10-1020-10-1020-10-1020-10-1020-10-1020-10-1020-10-1020-10-1020-10-1020-10-1020-10-1020-10-1020-10-1020-10-1020-10-1020-10-1020-10-1020-10-1020-10-1020-10-1020-10-1020-10-1020-10-1020-10-100009008020-10-10000901000009011020-10-1020-10-1020-10-1020-10-1020-10-1020-10-1020-10-1020-10-1020-10-1020-10-1020-10-1020-10-1020-10-1020-10-1020-10-1020-10-1020-10-1020-10-1020-10-10900400009004001090040020900400109004002
020-10-1020-10-1020-10-1020-10-1020-10-1020-10-1020-10-1020-10-1020-10-1020-10-1020-10-1020-10-1020-10-1020-10-1020-10-1020-10-1020-10-1020-10-1020-10-1020-10-1020-10-1020-10-1020-10-1020-10-1020-10-1020-10-1020-10-1020-10-1020-10-1020-10-1020-10-1020-10-1020-10-1020-10-1020-10-1020-10-1020-10-1020-10-1020-10-1020-10-1020-10-1020-10-1020-10-1020-10-1020-10-1020-10-1020-10-1020-10-1020-10-1020-10-1020-10-1020-10-1020-10-1020-10-1020-10-1020-10-1020-10-1020-10-1020-10-1020-10-1
020-10-1020-10-1020-10-1020-10-1020-10-1020-10-1020-10-1020-10-1020-10-1020-10-1020-10-1020-10-1020-10-1020-10-1020-10-1020-10-1020-10-1020-10-1020-10-1020-10-1020-10-1020-10-1020-10-1020-10-1020-10-1020-10-1020-10-1020-10-1020-10-1020-10-1020-10-1020-10-1020-10-1020-10-1020-10-1020-10-1020-10-1020-10-1020-10-1020-10-1020-10-1020-10-1020-10-1020-10-1020-10-1020-10-1020-10-1020-10-1020-10-1020-10-1020-10-1020-10-1020-10-1020-10-1020-10-1020-10-1020-10-1020-10-1020-10-1020-10-1
020-10-1020-10-1020-10-1020-10-1020-10-1020-10-1020-10-1000-10-1000-10-1000-10-1000-10-1000-10-1000-10-1000-10-1000-10-1000-10-1020-10-1020-10-1020-10-1020-10-1020-10-1020-10-1020-10-1020-10-1020-10-1020-10-1020-10-1020-10-1020-10-1020-10-1020-10-1020-10-1020-10-1020-10-1020-10-1020-10-1020-10-1020-10-1020-10-1020-10-1020-10-1020-10-1020-10-1020-10-1020-10-1020-10-1020-10-1020-10-1020-10-1020-10-1020-10-1020-10-1020-10-1020-10-1020-10-1020-10-1020-10-1020-10-1020-10-1020-10-1
020-10-1020-10-1020-10-1020-10-1000-10-1000-10-1000-10-1000-10-1000-10-1000-10-1000-10-1000-10-1000-10-1000-10-1000-10-1000-10-1020-10-1020-10-1020-10-1020-10-1020-10-1020-10-1020-10-1020-10-1020-10-1020-10-1020-10-1020-10-1020-10-1020-10-1020-10-1020-10-1020-10-1020-10-1020-10-1020-10-1020-10-1020-10-1020-10-1020-10-1020-10-1020-10-1020-10-1020-10-1020-10-1020-10-1020-10-1020-10-1020-10-1020-10-1020-10-1020-10-1020-10-1020-10-1020-10-1020-10-1020-10-1020-10-1020-10-1020-10-1
020-10-1020-10-1020-10-1020-10-1020-10-1020-10-1000-10-1000-10-1000-10-1000-10-1000-10-1000-10-1000-10-1000-10-1000-10-1000-10-1000-10-1020-10-1020-10-1020-10-1020-10-1020-10-1020-10-1020-10-1020-10-1020-10-1020-10-1020-10-1020-10-1020-10-1020-10-1020-10-1020-10-1020-10-1020-10-1020-10-1020-10-1020-10-1020-10-1020-10-1020-10-1020-10-1020-10-1020-10-1020-10-1020-10-1020-10-1020-10-1020-10-1020-10-1020-10-1020-10-1020-10-1020-10-1020-10-1020-10-1020-10-1020-10-1020-10-1020-10-1
09000001090000020900000309000004020-10-1020-10-1020-10-1000-10-1000-10-1000-10-1000-10-1000-10-1000-10-1000-10-1000-10-1000-10-1020-10-1020-10-1020-10-1020-10-1020-10-1020-10-1020-10-1020-10-1020-10-1020-10-1020-10-1020-10-1020-10-1020-10-1020-10-1020-10-1020-10-1020-10-1020-10-1020-10-1020-10-1020-10-1020-10-1020-10-1020-10-1020-10-1020-10-1020-10-1020-10-1020-10-1020-10-1020-10-1020-10-1020-10-1020-10-1020-10-1020-10-1020-10-1020-10-1020-10-1020-10-1020-10-1020-10-1020-10-1
09001001090010020900100309001004020-10-1020-10-100002036000020470000204700002047000020470000204700002047000020470000204700002047000020470000204700002048020-10-1020-10-1020-10-1020-10-1020-10-1020-10-1020-10-1020-10-1020-10-1020-10-1020-10-1020-10-1020-10-1020-10-1020-10-1020-10-1020-10-1020-10-1020-10-1020-10-1020-10-1020-10-1020-10-1020-10-1020-10-1020-10-1020-10-1020-10-1020-10-1020-10-1020-10-1020-10-1020-10-1020-10-1020-10-1020-10-1020-10-1020-10-1020-10-1020-10-1020-10-1
09002001090020020900200309002004020-10-1020-10-100003036000030370000303800003039000030400000304100003042000030430000304400003045000030460000304700003048020-10-1020-10-1020-10-1020-10-1020-10-1020-10-1020-10-1020-10-1020-10-1020-10-1020-10-1020-10-1020-10-1020-10-1020-10-1020-10-1020-10-1020-10-1020-10-1020-10-1020-10-1020-10-1020-10-1020-10-1020-10-1020-10-1020-10-104053043020-10-1020-10-1020-10-1020-10-1020-10-1020-10-1020-10-1020-10-1020-10-1020-10-1020-10-1020-10-1020-10-1
09001001090010020900300309003004020-10-1020-10-100004036000040370000403800004039000040400000404100004042000040430000404400004044000040440000404400004048020-10-1020-10-1020-10-1020-10-1020-10-1020-10-1020-10-1020-10-1020-10-1020-10-1020-10-1020-10-1020-10-1040100650401006604010067020-10-1020-10-104052033040520340405203504052036020-10-1020-10-1020-10-1040530400405304104053042020-10-1020-10-1020-10-1020-10-1020-10-1020-10-1020-10-1020-10-1020-10-109001001090010020900100109001002
09002001090020020900200309002004020-10-1020-10-1020-10-1000-10-1000-10-1000-10-1000-10-1000-10-1000-10-1000-10-1000-10-1000-10-1020-10-1020-10-1020-10-1020-10-1020-10-1020-10-1020-10-1020-10-1020-10-1020-10-1020-10-1020-10-1020-10-1020-10-1020-10-1020-10-104011065040110660401106704011068040530320405303304053034040530350405303604053037040540380405403904054040040540410405404204054043020-10-1020-10-1020-10-1020-10-1020-10-1020-10-1020-10-1020-10-109002001090020020900200109002002
09001001090010020900300309003004020-10-1020-10-1000-10-1000-10-1000-10-1000-10-1000-10-1000-10-1000-10-1000-10-1000-10-1000-10-1020-10-1020-10-1020-10-1020-10-1020-10-1020-10-1020-10-1020-10-1020-10-1020-10-1020-10-1020-10-1020-10-1020-10-1020-10-10401206404012065040120660401206704012068040540320405403304054034040540350405403604054037040550380405503904055040040550410405504204055043020-10-1020-10-1020-10-1020-10-1020-10-1020-10-1020-10-1020-10-109001001090010020900100109001002
09002001090020020900200309002004020-10-1020-10-1020-10-1020-10-1020-10-1000-10-1000-10-1000-10-1000-10-1000-10-1000-10-1020-10-1020-10-1020-10-1020-10-1020-10-1020-10-1020-10-1020-10-1020-10-1020-10-1020-10-1020-10-1020-10-1020-10-1020-10-1020-10-1020-10-104013065040130660401306704013068040550320405503304055034040550350405503604055037040560380405603904056040040560410405604204056043020-10-1020-10-1020-10-1020-10-1020-10-1020-10-1020-10-1020-10-109002001090020020900200109002002
09001001090010020900300309003004020-10-1020-10-1020-10-1020-10-1020-10-1020-10-1020-10-1020-10-1020-10-1020-10-1020-10-1020-10-1020-10-1020-10-1020-10-1020-10-1020-10-1020-10-1020-10-1020-10-1020-10-1020-10-1020-10-1020-10-1020-10-1020-10-1020-10-1020-10-1020-10-1020-10-1020-10-1020-10-1020-10-1040-10-1040-10-1020-10-1020-10-1020-10-1020-10-1020-10-1020-10-1020-10-1020-10-1020-10-1020-10-1020-10-1020-10-1020-10-1020-10-1020-10-1020-10-1020-10-109001001090010020900100109001002
09002001090020020900200309002004020-10-1020-10-1020-10-1020-10-1020-10-1020-10-1020-10-1020-10-1020-10-1020-10-1020-10-1020-10-1020-10-1020-10-1020-10-1020-10-1020-10-1020-10-1020-10-1020-10-1020-10-1020-10-1020-10-1020-10-1020-10-1020-10-1020-10-1020-10-1020-10-1020-10-1020-10-1020-10-1020-10-1020-10-1020-10-1020-10-1020-10-1020-10-1020-10-1020-10-1020-10-1020-10-1020-10-1020-10-1020-10-1020-10-1020-10-1020-10-1020-10-1020-10-1020-10-1020-10-109002001090020020900200109002002
09001001090010020900300309003004020-10-1020-10-1020-10-1020-10-1020-10-1020-10-1020-10-1020-10-1020-10-1020-10-1020-10-1020-10-1020-10-1020-10-1020-10-1020-10-1020-10-1020-10-1020-10-1020-10-1020-10-1020-10-1020-10-1020-10-1020-10-1020-10-1020-10-1020-10-1020-10-1020-10-1020-10-1020-10-1020-10-1020-10-1020-10-1020-10-1020-10-1020-10-1020-10-1020-10-1020-10-1020-10-1020-10-1020-10-1020-10-1020-10-1020-10-1020-10-1020-10-1020-10-1020-10-1020-10-109001001090010020900100109001002
09002001090020020900200309002004020-10-1020-10-1020-10-1020-10-1020-10-1020-10-1020-10-1020-10-1020-10-1020-10-1020-10-1020-10-1020-10-1020-10-1020-10-1020-10-1020-10-1020-10-1020-10-1020-10-1020-10-1020-10-1020-10-1020-10-1020-10-1020-10-1020-10-1020-10-1020-10-1020-10-1020-10-1020-10-1020-10-1020-10-1020-10-1020-10-1020-10-1020-10-1020-10-1020-10-1020-10-1020-10-1020-10-1020-10-1020-10-1020-10-1020-10-1020-10-1020-10-1020-10-1020-10-1020-10-109002001090020020900200109002002
09001001090010020900300309003004020-10-1020-10-1020-10-1020-10-1020-10-1020-10-1020-10-1020-10-1020-10-1020-10-1020-10-1020-10-1020-10-1020-10-1020-10-1020-10-1020-10-1020-10-1020-10-1020-10-1020-10-1020-10-1020-10-1020-10-1020-10-1020-10-1020-10-1020-10-1020-10-1020-10-1020-10-1020-10-1020-10-1020-10-1020-10-1020-10-1020-10-1020-10-1020-10-1020-10-1020-10-1020-10-1020-10-1020-10-1020-10-1020-10-1020-10-1020-10-1020-10-1020-10-1020-10-1020-10-109001001090010020900100109001002
09002001090020020900200309002004020-10-1020-10-1020-10-1020-10-1020-10-1020-10-1020-10-1020-10-1020-10-1020-10-1020-10-1020-10-1020-10-1020-10-1020-10-1020-10-1020-10-1020-10-1020-10-1020-10-1020-10-1020-10-1020-10-1020-10-1020-10-1020-10-1020-10-1020-10-1020-10-1020-10-1020-10-1020-10-1020-10-1020-10-1020-10-1020-10-1020-10-1020-10-1020-10-1020-10-1020-10-1020-10-1020-10-1020-10-1020-10-1020-10-1020-10-1020-10-1020-10-1020-10-1020-10-1020-10-109002001090020020900200109002002
09001001090010020900300309003004020-10-1020-10-1020-10-1020-10-1020-10-1020-10-1020-10-1020-10-1020-10-1020-10-1020-10-1020-10-1020-10-1020-10-1020-10-1020-10-1020-10-1020-10-1020-10-1020-10-1020-10-1020-10-1020-10-1020-10-1020-10-1020-10-1020-10-1020-10-1020-10-1020-10-1020-10-1020-10-1020-10-1020-10-1020-10-1020-10-1020-10-1020-10-1020-10-1020-10-1020-10-1020-10-1020-10-1020-10-1020-10-1020-10-1020-10-1020-10-1020-10-1020-10-1020-10-1020-10-109001001090010020900100109001002
090020010900200209000001090000020900000109000002090000010900000209000001090000020900000109000002090000010900000209000001090000020900000109000002090000010900000209000001090000020900000109000002090000010900000209000001090000020900000109000002090000010900000209000001090000020900000109000002090000010900000209000001090000020900000109000002090000010900000209000001090000020900000109000002090000010900000209000001090000020900000109000002090000010900000209002001090020020900200109002002
090010010900100209001001090010020900100109001002090010010900100209001001090010020900100109001002090010010900100209001001090010020900100109001002090010010900100209001001090010020900100109001002090010010900100209001001090010020900100109001002090010010900100209001001090010020900100109001002090010010900100209001001090010020900100109001002090010010900100209001001090010020900100109001002090010010900100209001001090010020900100109001002090010010900100209001001090010020900100109001002
090020010900200209002001090020020900200109002002090020010900200209002001090020020900200109002002090020010900200209002001090020020900200109002002090020010900200209002001090020020900200109002002090020010900200209002001090020020900200109002002090020010900200209002001090020020900200109002002090020010900200209002001090020020900200109002002090020010900200209002001090020020900200109002002090020010900200209002001090020020900200109002002090020010900200209002001090020020900200109002002
090010010900100209001001090010020900100109001002090010010900100209001001090010020900100109001002090010010900100209001001090010020900100109001002090010010900100209001001090010020900100109001002090010010900100209001001090010020900100109001002090010010900100209001001090010020900100109001002090010010900100209001001090010020900100109001002090010010900100209001001090010020900100109001002090010010900100209001001090010020900100109001002090010010900100209001001090010020900100109001002
090020010900200209002001090020020900200109002002090020010900200209002001090020020900200109002002090020010900200209002001090020020900200109002002090020010900200209002001090020020900200109002002090020010900200209002001090020020900200109002002090020010900200209002001090020020900200109002002090020010900200209002001090020020900200109002002090020010900200209002001090020020900200109002002090020010900200209002001090020020900200109002002090020010900200209002001090020020900200109002002
