60
40
020000000200000002000000020000000200000002000000020000000200000002000000020000000200701902000000020000000200000002000000020000000200000002000000020000000200000002000000020000000200000002000000020000000200000002000000020000000200000002000000020000000200000002000000020000000200000002000000020000000200000002000000020000000200000002000000020000000200000002000000020000000200000002000000020000000200000002000000020000000200000002000000020000000200000002000000020000000200000002000000
020070190200701902007019020070190200701902007019020070190200701902007019020070190200701902007019020070190200701902007019020070190200701902007019020070190200701902007019020070190200701902007019020070190200701902007019020070190200701902007019020070190200701902007019020070190200701902007019020070190200701902007019020070190200701902007019020070190200701902007019020070190200701902007019020070190200701902007019020070190200701902007019020070190200701902007019020070190200701902007019
020000000200701902007019020070190200701902000000020000000200000002007019020070190200000002000000020000000200000002000000020000000200000002000000020000000200000002000000020000000200000002000000020000000200000002000000020000000200000002000000020000000200000002000000020000000200000002000000020000000200000002000000020000000200000002000000020000000200000002000000020000000200000002000000020000000200000002000000020000000200000002000000020000000200000002007019020070190200701902007019
020070190200701902007019020070190200701902007019020070190200701902007019020070190200701902007019020070190200701902007019020070190200701902007019020070190200701902007019020070190200701902007019020070190200701902007019020070190200701902007019020070190200701902007019020070190200701902007019020070190200701902007019020070190200701902007019020070190200701902007019020070190200701902007019020070190200701902007019020070190200701902007019020070190200701902007019020070190200701902007019
020070190200701902007019020000000200000002000000020000000200000002000000020000000200000002000000020000000200000002000000020000000200000002000000020000000200000002000000020000000200000002000000020000000200000002000000020000000200000002000000020000000200000002000000020000000200000002000000020000000200000002000000020000000200000002000000020000000200000002000000020000000200000002000000020000000200000002000000020000000200000002000000020070190200701902007019020070190200000002007019
020070190200701902007019020000000200000002007019020000000200000002000000020000000200000002000000020000000200000002000000020000000200000002000000020000000200000002000000020000000200000002000000020000000200000002000000020000000200000002000000020000000200000002000000020000000200000002000000020000000200000002000000020000000200000002000000020000000200000002000000020000000200000002000000020000000200000002000000020000000200000002000000020070190200000002007019020070190200701902007019
020070190200701902007019020000000200000002031018020310200203102002031020020310200203102002031020020310200203102002031020020310200203102002031020020310200203102102007019020070190200701902007019020070190200701902009018020090200200902002009020020090200200902002009020020090200200902002009020020090200200902002009020020090200200902002009020020090200200902002009020020090200200902002009020020090210200701902000000020000000200000002000000020070190200000002007019020070190200701902007019
020070190200701902007019020070190200000002032018020320190203201902032019020320190203201902032019020320190203201902032019020320190203201902032019020320190203302102007019020000000200000002000000020000000200701902010018020100190201001902010019020100190201001902010019020100190201001902010019020100190201001902010019020100190201001902010019020100190201001902010019020100190201001902010019020100210200701902000000020000000200000002000000020070190200000002007019020070190201100102007019
020070190200701902007019020070190200000002032018020320190203201902032019020320190203201902032019020320190203201902032019020320190203201902032019020320190203302102000000020000000200000002000000020000000200701902010018020110200201102002011020020110200201102002011020020110200201102002011020020110200201102002011020020110200201102002011020020110200201102002011020020110200201102002011020020100210200701902000000020000000200000002000000020070190200000002000000020070190200701902007019
020070190200701902007019020070190200000002032018020320190203201902032019020320190203201902032019020320190203201902032019020320190203201902032019020320190203302102000000020000000200000002000000020070190200701902010018020100200201002002010020020100200201002002010020020100200201002002010020020100200201002002010020020100200201002002010020020100200201002002010020020100200201002002011020020100210200701902000000020000000200000002000000020070190200000002011001020070190201100102007019
020070190200701902007019020070190200000002032018020320190203201902032019020320190203201902032019020320190203201902032019020320190203201902032019020320190203302102000000020000000200000002000000020070190200701902010018020100200201002002010020020100200201002002010020020100200201002002010020020100200201002002010020020100190201001902010019020100190201001902010020020100200201002002011020020100210200701902000000020000000200000002000000020070190200000002000000020070190200701902000000
020070190200701902007019020000000200000002032018020320190203201902032019020320190203201902032019020320190203201902032019020320190203201902032019020320190203302102000000020000000200000002000000020070190200701902010018020100190201001902010019020100190201001902010019020100190201001902010019020100190201001902010019020100190201001902010019020100190201001902010019020100190201001902010019020100210200701902000000020000000200000002000000020070190200000002011001020070190200701902000000
020070190200701902007019020000000200000002032018020320190203201902032019020320190203201902032019020320190203201902032019020320190203202002032019020320190203302102000000020000000200000002000000020070190200701902012018020120190201201902012019020120190201201902012019020120190201201902012019020120190201201902012019020120190201201902012019020120190201201902012019020120190201201902012019020120210200701902000000020000000200000002000000020070190200000002000000020070190200701902000000
020070190200701902007019020000000200000002032018020320190203201902032019020320190203201902032019020320190203201902032019020320190203202002032020020320190203302102000000020000000200000002000000020070190200701902007019020070190200701902007019020070190200701902007019020070190200701902007019020070190200701902007019020070190200701902007019020070190200701902007019020070190200701902007019020070190200701902000000020000000200000002000000020070190200000002011001020070190200701902000000
020070190200701902007019020000000200701902034018020340190203401902034019020340190203401902034019020340190203401902034019020340190203401902034019020340190203402102000000020000000200000002000000020070190200701902007019020070190200701902007019020070190200701902007019020070190200701902007019020070190200701902007019020070190200701902007019020070190200701902007019020070190200701902007019020070190200701902000000020000000200000002000000020070190200000002007019020070190200701902000000
020070190200701902007019020000000200701902007019020070190200701902007019020070190200401202004011020070190200701902007019020070190200701902007019020070190200701902007019020070190200000002007019020070190200701902007019020070190200701902007019020070190200701902007019020070190200701902007019020070190200701902007019020070190200701902007019020070190200701902007019020070190200701902007019020070190200701902000000020000000200000002000000020070190200701902007019020000000200701902000000
020000000200701902007019020000000200701902007019020070190200701902007019020070190200501202007019020040110200701902007019020070190200701902007019020070190200701902007019020070190200701902007019020070190200701902000013020000140200001402000014020000140200001402000014020000140200001402000014020000140200001602007019020070190200701902007019020070190200701902007019020070190200701902007019020070190200701902000000020000000200000002000000020000000200000002000000020000000200000002000000
020070190200701902007019020000000200701902000013020000140200001402000014020000140200001402000014020000140200001402000014020000140200001402000014020000140200001402000014020000140200001402000014020000140200001402004013020010140200101402001014020010140200101402001014020010140200101402001014020010140200401402000015020000150200001502000014020000140200001402000014020000140200001402000014020000140200001602000000020000000201901802019020020190200201902002019020020190200201902002019020
020000000200701902007019020070190200000002002013020010140200101402001014020010140200101402001014020010140200101402001014020010140200101402001014020010140200101402001014020010140200101402001014020010140200101402002014020020140200201402002014020020140200201402002014020020140200201402002014020020140200201402002014020020140200201402002014020020140200201402002014020020140200201402002014020020140200101602000000020000000202001802020019020200190202001902020019020200190202001902020019
020000000200701902000000020070190200000002002013020010140200101402001014020010140200101402001014020010140200101402001014020010140200101402001014020010140200101402001014020010140200101402001014020020140200201402002014020020140200201402002014020020140200201402002014020020140200201402002014020020140200201402002014020020140200201402002014020020140200201402002014020020140200201402002014020020140200101602000000020000000202001802020019020200190202001902020019020200190202001902020019
020070190200701902007019020070190200000002002013020010140200101402001014020010140200101402001014020010140200101402001014020010140200101402001014020010140200101402001014020010140200101402001014020020140200201402002014020020140200201402002014020020140200201402002014020020140200201402002014020020140200201402002014020020140200201402002014020020140200201402002014020020140200201402002014020020140200101602000000020000000202001802020019020200190202001902020019020200190202001902020019
020070190200701902007019020000000200000002003013020030140200301402003014020030140200301402003014020030140200301402003014020030140200301402003014020030140200301402003014020050130200101402001014020050140200301502003015020030150200301502003015020030150200301502003015020030150200301502003015020030150200301502003015020030150200301502003015020030150200301502003015020030150200301502003015020030150200301602000000020000000202001802020019020200190202001902020019020200190202001902020019
020070190200701902007019020000000200000002015018020150190201501902015019020150190201501902015019020150190201501902015019020150190201501902015019020150190201501902015021020010130200101402001014020020160200701902007019020070190200701902007019020070190200701902007019020070190200701902007019020070190200701902007019020070190200701902007019020070190200701902007019020070190200701902007019020070190200701902000000020000000202201802022020020220200202202002022020020220200202202002022020
020070190200701902007019020000000200000002016018020190180201902002019020020190200201902002019020020190200201902002019020020190200201902002019020020190200201902102017021020010130200101402001014020020160200701902009018020090190200901902009019020090190200901902009019020090190200901902009019020090190200901902009019020090190200901902009019020090190200901902009019020090190200901902009019020090210200701902000000020000000200000002000000020070190200701902007019020070190200701902000000
020000000200701902007019020000000200000002016018020200180202001902020019020200190202001902020019020200190202001902020019020200190202001902020019020200190202002102017021020010130200101402001014020020160200701902010018020090220200902402009024020090240200902402009024020090240200902402009024020090240200902402009024020090240200902402009024020090240200902402009024020090240200902402009025020100210200701902000000020000000200000002007019020070190200701902000000020000000200701902000000
020110010200701902007019020000000200000002016018020200180202001902020019020200190202001902020019020200190202001902020019020200190202001902020019020200190202002102017021020010130200101402001014020020160200701902010018020100220201002302010023020100230201002302010023020100230201002302010023020100230201002302010023020100230201002302010023020100230201002302010023020100230201002302010025020100210200701902000000020000000200000002007019020070190200701902007019020070190200701902000000
020000000200701902007019020000000200000002016018020200180202001902020019020200190202001902020019020200190202001902020019020200190202001902020019020200190202002102017021020010130200101402001014020020160200701902010018020100220201002302010023020100230201002302010023020100230201002302010023020100230201002302010023020100230201002302010023020100230201002302010023020100230201002302011025020100210200701902000000020000000200000002007019020070190200701902007019020000000200701902000000
020110010200701902007019020000000200000002016018020200180202001902020019020200190202001902020019020200190202001902020019020200190202001902020019020200190202002102017021020010130200101402001014020020160200701902010018020100220201002302010023020100230201002302010023020100230201002302011023020110230201102302011023020110230201102302011023020110230201102302011023020110230201002302011025020100210200701902000000020000000200000002007019020070190200701902007019020000000200701902000000
020000000200701902007019020000000200000002016018020200180202002002020020020200200202002002020020020200200202002002020020020200200202002002020020020200200202002102017021020010130200101402001014020020160200701902010018020100220201102302011023020110230201102302011023020110230201102302011023020110230201102302011023020110230201102302011023020110230201102302011023020110230201102302011025020100210200701902000000020000000200000002007019020070190200701902007019020000000200701902000000
020110010200701902007019020000000200000002016018020220180202201902022019020220190202201902022019020220190202201902022019020220190202201902022019020220190202202102017021020010130200101402001014020020160200701902010018020120220201202302012023020120230201202302012023020120230201202302012023020120230201202302012023020120230201202302012023020120230201202302012023020120230201202302012025020100210200701902000000020000000200000002007019020070190200701902007019020070190200701902000000
020070190200701902007019020000000200000002018018020180190201801902018019020180190201801902018019020180190201801902018019020180190201801902018019020180190201801902018021020030130200301402003014020030160200701902012018020120200201202002012020020120200201202002012020020120200201202002012020020120200201202002012020020120200201202002012020020120200201202002012020020120200201202002012020020120210200701902000000020000000200000002007019020070190200701902007019020070190200701902000000
020070190200701902007019020000000200000002000000020000000200000002004012020000000200000002000000020000000200000002000000020000000200000002000000020000000200000002000000020000000200401202000000020000000200000002000000020000000200000002000000020000000200000002000000020000000200000002000000020000000200000002000000020000000200000002000000020000000200000002000000020000000200000002000000020000000200000002000000020000000200000002000000020070190200000002007019020000000200701902000000
020000000200701902007019020000000200000002000000020000000200000002005012020000000200401102005011020040120200000002000000020040110200401102000000020000000200501102000000020040110200501202000000020000000200000002000000020000000200000002000000020000000200000002000000020000000200000002000000020000000200000002000000020000000200000002000000020000000200000002000000020000000200000002000000020000000200000002000000020000000200000002000000020070190200000002000000020000000200701902000000
020110010200701902007019020000000200000002000000020000000200000002005011020000000200501102000000020050120200401102004011020000000200501102000000020040110200000002005011020000000200000002000000020000000200000002000000020000000200000002000000020000000200000002000000020000000200000002000000020000000200000002000000020000000200000002000000020000000200000002000000020000000200000002000000020000000200000002000000020000000200000002000000020070190200000002011001020000000200701902007019
020000000200701902007019020000000200000002000000020000000200000002000000020000000200000002000000020000000200000002000000020000000200000002000000020000000200000002000000020000000200000002000000020000000200000002000000020000000200000002000000020000000200000002000000020000000200000002000000020000000200000002000000020000000200000002000000020000000200000002000000020000000200000002000000020000000200000002000000020000000200000002000000020070190200000002000000020070190200701902007019
020070190200701902007019020070190200701902007019020070190200701902007019020070190200701902007019020070190200701902007019020070190200701902007019020070190200701902007019020070190200701902007019020070190200701902007019020070190200701902007019020070190200701902007019020070190200701902007019020070190200701902007019020070190200701902007019020070190200701902007019020070190200701902007019020070190200701902007019020070190200701902007019020070190200000002011001020000000200701902007019
020070190200701902007019020000000200000002000000020000000200000002000000020000000200000002000000020000000200000002000000020000000200000002000000020000000200000002000000020000000200000002000000020000000200000002000000020000000200000002000000020000000200000002000000020000000200000002000000020000000200000002000000020000000200000002000000020000000200000002000000020000000200000002000000020000000200000002000000020000000200000002000000020000000200000002000000020070190200701902000000
020070190200701902007019020070190200701902007019020070190200701902007019020070190200701902007019020070190200701902007019020070190200701902007019020070190200701902007019020070190200701902007019020070190200701902007019020070190200701902007019020070190200701902007019020070190200701902007019020070190200701902007019020070190200701902007019020070190200701902007019020070190200701902007019020070190200701902007019020070190200701902007019020070190200701902007019020070190200701902007019
020070190200701902007019020000000200000002000000020000000200000002000000020000000200000002000000020000000200000002000000020000000200000002000000020000000200000002000000020000000200000002000000020000000200000002000000020000000200000002000000020000000200000002000000020000000200000002000000020000000200000002000000020000000200000002000000020000000200000002000000020000000200000002000000020000000200000002000000020000000200000002000000020000000200000002007019020070190200000002007019
020070190200701902007019020070190200701902007019020070190200701902007019020070190200701902007019020070190200701902007019020070190200701902007019020070190200701902007019020070190200701902007019020070190200701902007019020070190200701902007019020070190200701902007019020070190200701902007019020070190200701902007019020070190200701902007019020070190200701902007019020070190200701902007019020070190200701902007019020070190200701902007019020070190200701902007019020070190200701902007019
