60
40
000000000000000000000000000000000000000000000000000000000000
000000000000000000000000000000000000000000000000000000000000
000000000000000000000000000000000000000000000000000000000000
111111111111111111111111111111111111111111111111111111111111
111111111111111111111111111111111111111111111111111111111111
110000000000000000000000000000000000000000000000000000011111
110000000000000000001100110000000000000000000000000000011111
110000100000001000001100110011100000000000001110000000011111
110000000000000000000000000111110111101111011111000000011111
110000000000000000000000000111110111101111011111000000011111
110000100000001000000000000101110101101011010111000000011111
110000000000000011000000000000000000001000000001000000011111
110000000000000011000000000000000000000000000000000000011111
110000100000001011000000001000101001000000000000000000011111
110000000000000000000000001101101111000000000000000000011111
111100000000000000000000001101101011000000000000000000011111
111100000000000000000000000000000000000000000000000000011111
000000000000000000000000000000000000000000000000000000000000
000000000000000000000000000000000000000000000000000000000000
000000000000000000000000000000000000000000000000000000000000
000000000000000000000000000000000000000000000000000000000000
000000000000000000000000000000000000000000000000000000000000
000000000000000000000000000000000000000000000000000000000000
110000000000000000000000000000000000000000000000000000000000
110000000000000000000000000000000000000000000000000000011000
110000111111111111100000000000000000000000000000000000011111
110000111111111111100000000000000000001100000000000000011111
110000111111111111100000000000001011011110010110000000011111
110000111111111111100000000000001011010110010110000000011111
110000000101000000000000000000000000010010000010000000011111
110000000000000000000000000000000000000000000000000000011111
110000000000000000000000000000000000000000000000000000011111
110000000000000000000000001000000000000000000000000000011111
110000000000000000000000000000000000000000000000000000011111
110000000000000000000000000000000000000000000000010000001111
110000000000000000000000000000000000000000000000000000001111
110000000000000000000000000000000000000000000000000000001111
111111111111111111111111111111111111111111111111111111111111
111111111111111111111111111111111111111111111111111111111111
110000000000000000000000000000000000000000000000000000000000
