60
40
020-10-1020-10-1020-10-1020-10-1020-10-1020-10-1020-10-1020-10-1020-10-1020-10-1020-10-1020-10-1020-10-1020-10-1020-10-1020-10-1020-10-1020-10-1020-10-1020-10-1020-10-1020-10-1020-10-1020-10-1020-10-1020-10-1020-10-1020-10-1020-10-1020-10-1020-10-1020-10-1020-10-1020-10-1020-10-1020-10-1020-10-1020-10-1020-10-1020-10-1020-10-1020-10-1020-10-1020-10-1020-10-1020-10-1020-10-1020-10-1020-10-1020-10-1020-10-1020-10-1020-10-1020-10-1020-10-1020-10-1020-10-1020-10-1020-10-1020-10-1
020-10-1020-10-1020-10-1020-10-1020-10-1020-10-1020-10-1020-10-1020-10-1020-10-1020-10-1020-10-1020-10-1020-10-1020-10-1020-10-1020-10-1020-10-1020-10-1020-10-1020-10-1020-10-1020-10-1020-10-1020-10-1020-10-1020-10-1020-10-1020-10-1020-10-1020-10-1020-10-1020-10-1020-10-1020-10-1020-10-1020-10-1020-10-1020-10-1020-10-1020-10-1020-10-1020-10-1020-10-1020-10-1020-10-1020-10-1020-10-1020-10-1020-10-1020-10-1020-10-1020-10-1020-10-1020-10-1020-10-1020-10-1020-10-1020-10-1020-10-1
020-10-1020-10-1020-10-1020-10-1020-10-1020-10-1020-10-1020-10-1020-10-1020-10-1020-10-1020-10-1020-10-1020-10-1020-10-1020-10-1020-10-1020-10-1020-10-1020-10-1020-10-1020-10-1020-10-1020-10-1020-10-1020-10-1020-10-1020-10-1020-10-1020-10-1020-10-1020-10-1020-10-1020-10-1020-10-1020-10-1020-10-1020-10-1020-10-1020-10-1020-10-1020-10-1020-10-1020-10-1020-10-1020-10-1020-10-1020-10-1020-10-1020-10-1020-10-1020-10-1020-10-1020-10-1020-10-1020-10-1020-10-1020-10-1020-10-1020-10-1
090050010900500209005001090050020900500109005002090050010900500209005001090050020900500109005002090050010900500209005001090050020900500109005002090050010900500209005001090050020900500109005002090050010900500209005001090050020900500109005002090050010900500209005001090050020900500109005002090050010900500209005001090050020900500109005002090050010900500209005001090050020900500109005002090050010900500209005001090050020900500109005002090050010900500209005001090050020900500109005002
090060010900600209006001090060020900600109006002090060010900600209006001090060020900600109006002090060010900600209006001090060020900600109006002090060010900600209006001090060020900600109006002090060010900600209006001090060020900600109006002090060010900600209006001090060020900600109006002090060010900600209006001090060020900600109006002090060010900600209006001090060020900600109006002090060010900600209006001090060020900600109006002090060010900100009001001090060020900600109006002
0900500109005002020-10-1020-10-1020-10-1020-10-1020-10-1020-10-1020-10-1020-10-1020-10-1020-10-1020-10-1020-10-1020-10-1020-10-1020-10-1020-10-1020-10-1020-10-1020-10-1020-10-1020-10-1020-10-1020-10-1020-10-1020-10-1020-10-1020-10-1020-10-1020-10-1020-10-1020-10-1020-10-1020-10-1020-10-1020-10-1020-10-1020-10-1020-10-1020-10-1020-10-1020-10-1020-10-1020-10-1020-10-1020-10-1020-10-1020-10-1020-10-1020-10-1020-10-1020-10-1020-10-1020-10-10900200009002001090050020900500109005002
0900600109006002020-10-1020-10-1020-10-1020-10-1020-10-1020-10-1020-10-1020-10-1020-10-1020-10-1020-10-1020-10-1020-10-1020-10-1020-10-1020-10-1020-10-1020-10-10200800702008007020-10-1020-10-10200800702008007020-10-1020-10-1020-10-1020-10-1020-10-1020-10-1020-10-1020-10-1020-10-1020-10-1020-10-1020-10-1020-10-1020-10-1020-10-1020-10-1020-10-1020-10-1020-10-1020-10-1020-10-1020-10-1020-10-1020-10-1020-10-1020-10-1020-10-1020-10-1020-10-10900100009001001090060020900600109006002
0900500109005002020-10-1020-10-1020-10-1020-10-104092032020-10-1020-10-1020-10-1020-10-1020-10-1020-10-1020-10-104092040020-10-1020-10-1020-10-1020-10-1020-10-10200800702008007020-10-1020-10-10200800702008007020-10-1020-10-1000090220000902300009024020-10-1020-10-1020-10-1020-10-1020-10-1020-10-1020-10-1020-10-1020-10-1020-10-1020-10-1020-10-1020-10-1000200150002001600020017020-10-1020-10-1020-10-1020-10-1020-10-1020-10-1020-10-1020-10-10900200009002001090050020900500109005002
0900600109006002020-10-1020-10-1020-10-1020-10-1020-10-1020-10-1020-10-1020-10-1020-10-1020-10-1020-10-1020-10-1020-10-1020-10-1020-10-1020-10-1020-10-1020-10-1020-10-1020-10-1020-10-1020-10-1020-10-1020-10-1020-10-10001002100010022000100230001002400010025020-10-100008014000080150000801600008017020-10-100021022000210230002102400021025020-10-10002101400021015000210160002101700021018020-10-1020-10-1020-10-1020-10-1020-10-1020-10-1020-10-10900100009001001090060020900600109006002
0900500109005002020-10-1020-10-1020-10-1020-10-1020-10-1020-10-1020-10-1020-10-1020-10-1020-10-1020-10-1020-10-1020-10-1020-10-1020-10-1020-10-1020-10-1020-10-1020-10-1020-10-1020-10-1020-10-1020-10-1020-10-1020-10-10001102100011022000110230001102400011025020-10-100009014000090150000901600009017020-10-100022022000220230002202400022025020-10-10002201400022015000220160002201700022018020-10-1020-10-1020-10-1020-10-1020-10-1020-10-1020-10-10900200009002001090050020900500109005002
0900600109006002020-10-1020-10-1020-10-1020-10-104095032020-10-1020-10-1020-10-1020-10-1020-10-1020-10-1020-10-104095040020-10-1020-10-1020-10-1020-10-1020-10-1020-10-1020-10-1020-10-1020-10-1020-10-1020-10-1020-10-100012021020-10-1000120230001202400012025020-10-100010014020-10-10001001600010017020-10-100023022020-10-10002302400023025020-10-100023014020-10-1000230160002301700023018020-10-1020-10-1020-10-1020-10-1020-10-1020-10-1020-10-10900100009001001090060020900600109006002
0900500109005002020-10-1020-10-1020-10-1020-10-1020-10-1020-10-1020-10-1020-10-1020-10-1020-10-1020-10-1020-10-1020-10-1020-10-10002105100021052020-10-1020-10-1020-10-1020-10-1020-10-1020-10-1020-10-1020-10-1020-10-1020-10-1020-10-1020-10-1020-10-1020-10-1020-10-1020-10-1020-10-1020-10-1020-10-1020-10-102027001020-10-1020-10-1020-10-1020-10-1020-10-1020-10-1020-10-1020-10-102028002020-10-1020-10-1020-10-1020-10-1020-10-1020-10-1020-10-10900200009002001090050020900500109005002
0900600109006002020-10-1020-10-1020-10-1020-10-1020-10-1020-10-1020-10-1020-10-1020-10-1020-10-1020-10-1020-10-1020-10-1020-10-10002205100022052020-10-1020-10-1020-10-1020-10-1020-10-1020-10-1020-10-1020-10-1020-10-1020-10-1020-10-1020-10-1020-10-1020-10-1020-10-1020-10-1020-10-1020-10-1020-10-1020-10-1020-10-1020-10-1020-10-1020-10-1020-10-1020-10-1020-10-1020-10-1020-10-1020-10-1020-10-1020-10-1020-10-1020-10-1020-10-1020-10-1020-10-10900100009001001090060020900600109006002
0900500109005002020-10-1020-10-1020-10-1020-10-104098032020-10-1020-10-1020-10-1020-10-1020-10-1020-10-1020-10-104098040020-10-10002305100023052020-10-1020-10-1020-10-1020-10-1020-10-1020-10-1020-10-1020-10-100008001020-10-1020-10-1020-10-100008005020-10-100007008020-10-1020-10-100007011020-10-1020-10-1020-10-1020-10-1020-10-1020-10-1020-10-1020-10-1020-10-1020-10-1020-10-1020-10-1020-10-1020-10-1020-10-1020-10-1020-10-1020-10-1020-10-10900200009002001090050020900500109005002
0900600109006002020-10-1020-10-1020-10-1020-10-1020-10-1020-10-1020-10-1020-10-1020-10-1020-10-1020-10-1020-10-1020-10-1020-10-1020-10-1020-10-1020-10-1020-10-1020-10-1020-10-1020-10-1020-10-1020-10-1020-10-10000900100009002020-10-10000900400009005020-10-100008008000080090000801000008011020-10-1020-10-1020-10-1020-10-1020-10-1020-10-1020-10-1020-10-1020-10-1020-10-1020-10-1020-10-1020-10-1020-10-1020-10-1020-10-1020-10-1020-10-1020-10-10900100009001001090050020900500109005002
09005001090050020900500309005004020-10-1020-10-1020-10-1020-10-1020-10-1020-10-1020-10-1020-10-1020-10-1020-10-1020-10-1020-10-1020-10-1020-10-1020-10-1020-10-1020-10-1020-10-1020-10-1020-10-1020-10-1020-10-10001000100010002020-10-10001000400010005020-10-100009008020-10-10000901000009011020-10-1020-10-1020-10-1020-10-1020-10-1020-10-1020-10-1020-10-1020-10-1020-10-1020-10-1020-10-1020-10-1020-10-1020-10-1020-10-1020-10-1020-10-1020-10-10900500009005001090050020900500109005002
09006001090060020900600309006004020-10-1020-10-1020-10-1020-10-1020-10-1020-10-1020-10-1020-10-1020-10-1020-10-1020-10-1020-10-1020-10-1020-10-1020-10-1020-10-1020-10-1020-10-1020-10-1020-10-1020-10-1020-10-1020-10-1020-10-1020-10-1020-10-1020-10-1020-10-1020-10-1020-10-1020-10-1020-10-1020-10-1020-10-1020-10-1020-10-1020-10-1020-10-1020-10-1020-10-1020-10-1020-10-1020-10-1020-10-1020-10-1020-10-1020-10-1020-10-1020-10-1020-10-1020-10-10900600009006001090060020900600109006002
020-10-1020-10-1020-10-1020-10-1020-10-1020-10-1020-10-1020-10-1020-10-1020-10-1020-10-1020-10-1020-10-1020-10-1020-10-1020-10-1020-10-1020-10-1020-10-1020-10-1020-10-1020-10-1020-10-1020-10-1020-10-1020-10-1020-10-1020-10-1020-10-1020-10-1020-10-1020-10-1020-10-1020-10-1020-10-1020-10-1020-10-1020-10-1020-10-1020-10-1020-10-1020-10-1020-10-1020-10-1020-10-1020-10-1020-10-1020-10-1020-10-1020-10-1020-10-1020-10-1020-10-1020-10-1020-10-1020-10-1020-10-1020-10-1020-10-1020-10-1
020-10-1020-10-1020-10-1020-10-1020-10-1020-10-1020-10-1020-10-1020-10-1020-10-1020-10-1020-10-1020-10-1020-10-1020-10-1020-10-1020-10-1020-10-1020-10-1020-10-1020-10-1020-10-1020-10-1020-10-1020-10-1020-10-1020-10-1020-10-1020-10-1020-10-1020-10-1020-10-1020-10-1020-10-1020-10-1020-10-1020-10-1020-10-1020-10-1020-10-1020-10-1020-10-1020-10-1020-10-1020-10-1020-10-1020-10-1020-10-1020-10-1020-10-1020-10-1020-10-1020-10-1020-10-1020-10-1020-10-1020-10-1020-10-1020-10-1020-10-1
020-10-1020-10-1020-10-1020-10-1020-10-1020-10-1020-10-1020-10-1020-10-1020-10-1020-10-1020-10-1020-10-1020-10-1020-10-1020-10-1020-10-1020-10-1020-10-1020-10-1020-10-1020-10-1020-10-1020-10-1020-10-1020-10-1020-10-1020-10-1020-10-1020-10-1020-10-1020-10-1020-10-1020-10-1020-10-1020-10-1020-10-1020-10-1020-10-1020-10-1020-10-1020-10-1020-10-1020-10-1020-10-1020-10-1020-10-1020-10-1020-10-1020-10-1020-10-1020-10-1020-10-1020-10-1020-10-1020-10-1020-10-1020-10-1020-10-1020-10-1
020-10-1020-10-1020-10-1020-10-1020-10-1020-10-1020-10-1020-10-1020-10-1020-10-1020-10-1020-10-1020-10-1020-10-1020-10-1020-10-1020-10-1020-10-1020-10-1020-10-1020-10-1020-10-1020-10-1020-10-1020-10-1020-10-1020-10-1020-10-1020-10-1020-10-1020-10-1020-10-1020-10-1020-10-1020-10-1020-10-1020-10-1020-10-1020-10-1020-10-1020-10-1020-10-1020-10-1020-10-1020-10-1020-10-1020-10-1020-10-1020-10-1020-10-1020-10-1020-10-1020-10-1020-10-1020-10-1020-10-1020-10-1020-10-1020-10-1020-10-1
020-10-1020-10-1020-10-1020-10-1020-10-1020-10-1020-10-1020-10-1020-10-1020-10-1020-10-1020-10-1020-10-1020-10-1020-10-1020-10-1020-10-1020-10-1020-10-1020-10-1020-10-1020-10-1020-10-1020-10-1020-10-1020-10-1020-10-1020-10-1020-10-1020-10-1020-10-1020-10-1020-10-1020-10-1020-10-1020-10-1020-10-1020-10-1020-10-1020-10-1020-10-1020-10-1020-10-1020-10-1020-10-1020-10-1020-10-1020-10-1020-10-1020-10-1020-10-1020-10-1020-10-1020-10-1020-10-1020-10-1020-10-1020-10-1020-10-1020-10-1
020-10-1020-10-1020-10-1020-10-1020-10-1020-10-1020-10-1020-10-1020-10-1020-10-1020-10-1020-10-1020-10-1020-10-1020-10-1020-10-1020-10-1020-10-1020-10-1020-10-1020-10-1020-10-1020-10-1020-10-1020-10-1020-10-1020-10-1020-10-1020-10-1020-10-1020-10-1020-10-1020-10-1020-10-1020-10-1020-10-1020-10-1020-10-1020-10-1020-10-1020-10-1020-10-1020-10-1020-10-1020-10-1020-10-1020-10-1020-10-1020-10-1020-10-1020-10-1020-10-1020-10-1020-10-1020-10-1020-10-1020-10-1020-10-1020-10-1020-10-1
0900500109005002020-10-1020-10-1020-10-1020-10-1020-10-1020-10-1020-10-1020-10-1020-10-1020-10-1020-10-1020-10-1020-10-1020-10-1020-10-1020-10-1020-10-1020-10-1020-10-1020-10-1020-10-1020-10-1020-10-1020-10-1020-10-1020-10-1020-10-1020-10-1020-10-1020-10-1020-10-1020-10-1020-10-1020-10-1020-10-1020-10-1020-10-1020-10-1020-10-1020-10-1020-10-1020-10-1020-10-1020-10-1020-10-1020-10-1020-10-1020-10-1020-10-1020-10-1020-10-1020-10-1020-10-1020-10-1020-10-1020-10-1020-10-1020-10-1
0900600109006002020-10-1020-10-1020-10-1020-10-1000-10-1000-10-1020-10-1000-10-1000-10-1000-10-1020-10-1020-10-1020-10-1020-10-1020-10-1020-10-1020-10-1020-10-1020-10-1020-10-1020-10-1020-10-1020-10-1020-10-1020-10-1020-10-1020-10-1020-10-1020-10-1020-10-1020-10-1020-10-1020-10-1020-10-1020-10-1020-10-1020-10-1020-10-1020-10-1020-10-1020-10-1020-10-1020-10-1020-10-1020-10-1020-10-1020-10-1020-10-1020-10-1020-10-1020-10-1020-10-1020-10-10900100009001001020-10-1020-10-1020-10-1
0900500109005002020-10-1020-10-1020-10-1020-10-100005036000050370000503800005039000050400000504100005042000050430000504400005045000050460000504700005048020-10-1020-10-1020-10-1020-10-1020-10-1020-10-1020-10-1020-10-1020-10-1020-10-1020-10-1020-10-1020-10-1020-10-1020-10-1020-10-1020-10-1020-10-1020-10-1020-10-1020-10-1020-10-1020-10-1020-10-1020-10-1020-10-1020-10-1020-10-1020-10-1020-10-1020-10-1020-10-1020-10-1020-10-1020-10-1020-10-10900200009005001090050020900500109005002
0900600109006002020-10-1020-10-1020-10-1020-10-100006036000060370000603800006039000060400000604100006042000060430000604400006045000060460000604700006048020-10-1020-10-1020-10-1020-10-1020-10-1020-10-1020-10-1020-10-1020-10-1020-10-1020-10-1020-10-1020-10-1020-10-1020-10-1020-10-1020-10-1020-10-1020-10-10405603404056035040-10-1020-10-1020-10-1020-10-1020-10-1020-10-1020-10-1020-10-1020-10-1020-10-1020-10-1020-10-1020-10-1020-10-1020-10-10900100009006001090060020900600109006002
0900500109005002020-10-1020-10-1020-10-1020-10-100007036000070370000703800007039000070400000704100007042000070430000704400007045000070460000704700007048020-10-1020-10-1020-10-1020-10-1020-10-1020-10-1020-10-1020-10-1020-10-1020-10-1020-10-1020-10-1020-10-104014065020-10-10401406704014068020-10-104057033040570340405703504057036040-10-1020-10-104057039020-10-10405704104057042020-10-1020-10-1020-10-1020-10-1020-10-1020-10-1020-10-1020-10-10900200009005001090050020900500109005002
0900600109006002020-10-1020-10-1020-10-1020-10-100008036000080370000803800008039000080400000804100008042000080430000804400008044000080460000804600008046000-10-1020-10-1020-10-1020-10-1020-10-1020-10-1020-10-1020-10-1020-10-1020-10-1020-10-1020-10-1020-10-104015065020-10-10401506704015068040-10-104058033040-10-10405803504058036040-10-1020-10-104058039020-10-10405804104058042020-10-1020-10-1020-10-1020-10-1020-10-1020-10-1020-10-1020-10-10900100009006001090060020900600109006002
0900500109005002020-10-1020-10-1020-10-1020-10-1020-10-1000-10-1000-10-100009039000-10-100009041000-10-1020-10-1020-10-1020-10-1020-10-1020-10-1020-10-1020-10-1020-10-1020-10-1020-10-1020-10-1020-10-1020-10-1020-10-1020-10-1020-10-1020-10-1020-10-1020-10-1020-10-1020-10-1020-10-1020-10-1020-10-102027000040-10-1020-10-102027000020-10-1020-10-1020-10-1020-10-1020-10-102028002020-10-1020-10-1020-10-1020-10-1020-10-1020-10-1020-10-1020-10-10900200009005001090050020900500109005002
0900600109006002020-10-1020-10-1020-10-1020-10-1020-10-1020-10-1020-10-1020-10-1020-10-1020-10-1020-10-1020-10-1020-10-1020-10-1020-10-1020-10-1020-10-1020-10-1020-10-1020-10-1020-10-1020-10-1020-10-1020-10-1020-10-1020-10-1020-10-1020-10-1020-10-1020-10-1020-10-1020-10-1020-10-1020-10-1020-10-1020-10-1020-10-1020-10-1020-10-1020-10-1020-10-1020-10-1020-10-1020-10-1020-10-1020-10-1020-10-1020-10-1020-10-1020-10-1020-10-1020-10-1020-10-10900100009006001090060020900600109006002
0900500109005002020-10-1020-10-1020-10-1020-10-1020-10-1020-10-1020-10-1020-10-1020-10-1020-10-1020-10-1020-10-1020-10-1020-10-1020-10-1020-10-1020-10-1020-10-1020-10-1020-10-1020-10-1020-10-1020-10-1020-10-1020-10-1020-10-1020-10-1020-10-1020-10-1020-10-1020-10-1020-10-1020-10-1020-10-1020-10-1020-10-1020-10-1020-10-1020-10-1020-10-1020-10-1020-10-1020-10-1020-10-1020-10-1020-10-1020-10-1020-10-1020-10-1020-10-1020-10-1020-10-1020-10-10900200009005001090050020900500109005002
0900600109006002020-10-1020-10-1020-10-1020-10-1020-10-1020-10-1020-10-1020-10-1020-10-1020-10-1020-10-1020-10-1020-10-1020-10-1020-10-1020-10-1020-10-1020-10-1020-10-1020-10-1020-10-1020-10-1020-10-1020-10-102028000020-10-1020-10-1020-10-1020-10-1020-10-1020-10-1020-10-1020-10-1020-10-1020-10-1020-10-1020-10-1020-10-1020-10-1020-10-1020-10-1020-10-1020-10-1020-10-1020-10-1020-10-1020-10-1020-10-1020-10-1020-10-1020-10-1020-10-1020-10-10900100009006001090060020900600109006002
0900500109005002020-10-1020-10-1020-10-1020-10-1020-10-1020-10-1020-10-1020-10-1020-10-1020-10-1020-10-1020-10-1020-10-1020-10-1020-10-1020-10-1020-10-1020-10-1020-10-1020-10-1020-10-1020-10-1020-10-1020-10-1020-10-1020-10-1020-10-1020-10-1020-10-1020-10-1020-10-1020-10-1020-10-1020-10-1020-10-1020-10-1020-10-1020-10-1020-10-1020-10-1020-10-1020-10-1020-10-1020-10-1020-10-1020-10-1020-10-1020-10-1020-10-1020-10-1020-10-1020-10-1020-10-10900200009005001090050020900500109005002
0900600109006002020-10-1020-10-1020-10-1020-10-1020-10-1020-10-1020-10-1020-10-1020-10-1020-10-1020-10-1020-10-1020-10-1020-10-1020-10-1020-10-1020-10-1020-10-1020-10-1020-10-1020-10-1020-10-1020-10-1020-10-1020-10-1020-10-1020-10-1020-10-1020-10-1020-10-1020-10-1020-10-1020-10-1020-10-1020-10-1020-10-1020-10-1020-10-1020-10-1020-10-1020-10-1020-10-1020-10-1020-10-1020-10-1020-10-1020-10-102027003020-10-1020-10-1020-10-1020-10-1020-10-1020-10-109006001090060020900600109006002
0900500109005002020-10-1020-10-1020-10-1020-10-1020-10-1020-10-1020-10-1020-10-1020-10-1020-10-1020-10-1020-10-1020-10-1020-10-1020-10-1020-10-1020-10-1020-10-1020-10-1020-10-1020-10-1020-10-1020-10-1020-10-1020-10-1020-10-1020-10-1020-10-1020-10-1020-10-1020-10-1020-10-1020-10-1020-10-1020-10-1020-10-1020-10-1020-10-1020-10-1020-10-1020-10-1020-10-1020-10-1020-10-1020-10-1020-10-1020-10-1020-10-1020-10-1020-10-1020-10-1020-10-1020-10-1020-10-109005001090050020900500109005002
0900600109006002020-10-1020-10-1020-10-1020-10-1020-10-1020-10-1020-10-1020-10-1020-10-1020-10-1020-10-1020-10-1020-10-1020-10-1020-10-1020-10-1020-10-1020-10-1020-10-1020-10-1020-10-1020-10-1020-10-1020-10-1020-10-1020-10-1020-10-1020-10-1020-10-1020-10-1020-10-1020-10-1020-10-1020-10-1020-10-1020-10-1020-10-1020-10-1020-10-1020-10-1020-10-1020-10-1020-10-1020-10-1020-10-1020-10-1020-10-1020-10-1020-10-1020-10-1020-10-1020-10-1020-10-1020-10-109006001090060020900600109006002
090050010900500209005001090050020900500109005002090050010900500209005001090050020900500109005002090050010900500209005001090050020900500109005002090050010900500209005001090050020900500109005002090050010900500209005001090050020900500109005002090050010900500209005001090050020900500109005002090050010900500209005001090050020900500109005002090050010900500209005001090050020900500109005002090050010900500209005001090050020900500109005002090050010900500209005001090050020900500109005002
090050010900500209006001090060020900600109006002090060010900600209006001090060020900600109006002090060010900600209006001090060020900600109006002090060010900600209006001090060020900600109006002090060010900600209006001090060020900600109006002090060010900600209006001090060020900600109006002090060010900600209006001090060020900600109006002090060010900600209006001090060020900600109006002090060010900600209006001090060020900600109006002090060010900600209006001090060020900600109006002
0900600109006002020-10-1020-10-1020-10-1020-10-1020-10-1020-10-1020-10-1020-10-1020-10-1020-10-1020-10-1020-10-1020-10-1020-10-1020-10-1020-10-1020-10-1020-10-1020-10-1020-10-1020-10-1020-10-1020-10-1020-10-1020-10-1020-10-1020-10-1020-10-1020-10-1020-10-1020-10-1020-10-1020-10-1020-10-1020-10-1020-10-1020-10-1020-10-1020-10-1020-10-1020-10-1020-10-1020-10-1020-10-1020-10-1020-10-1020-10-1020-10-1020-10-1020-10-1020-10-1020-10-1020-10-1020-10-1020-10-1020-10-1020-10-1020-10-1
