40
40
020000020000020000020000020000020000020000020000020000020000020000020000020000020000020000020000020000020000020000020000020000020000020000020000020000020000020000020000020000020000020000020000020000020000020000020000020000020000020000020000
020000020000020000020000020000020000020000020000020000020000020000020000020000020000020000020000020000020000020000020000020000020000020000020000020000020000020000020000020000020000020000020000020000020000020000020000020000020000020000020000
020000020000020000020000020000020000020000020000020000020000020000020000020000020000020000020000020000020000020000020000020000020000020000020000020000020000020000020000020000020000020000020000020000020000020000020000020000020000020000020000
020000020000020000020000020000020000020000020000020000020000020000020000020000020000020000020000020000020000020000020000020000020000020000020000020000020000020000020000020000020000020000020000020000020000020000020000020000020000020000020000
020000020000020000020000020000020000020000020000020000020000020000020000020000020000020000020000020000020000020000020000020000020000020000020000020000020000020000020000020000020000020000020000020000020000020000020000020000020000020000020000
020000020000020000020000020000020000020000020000020000020000020000020000020000020000020000020000020000020000020000020000020000020000020000020000020000020000020000020000020000020000020000020000020000020000020000020000020000020000020000020000
020000020000020000020000020000020000020000020000020000020000020000020000020000020000020000020000020000020000020000020000020000020000020000020000020000020000020000020000020000020000020000020000020000020000020000020000020000020000020000020000
020000020000020000020000020000020000020000020000020000020000020000020000020000020000020000020000020000020000020000020000020000020000020000020000020000020000020000020000020000020000020000020000020000020000020000020000020000020000020000020000
020000020000020000020000020000020000020000020000020000020000020000020000020000020000020000020000020000020000020000020000020000020000020000020000020000020000020000020000020000020000020000020000020000020000020000020000020000020000020000020000
020000020000020000020000020000020000020000020000020000020000020000020000020000020000020000020000020000020000020000020000020000020000020000020000020000020000020000020000020000020000020000020000020000020000020000020000020000020000020000020000
020000020000020000020000020000020000020000020000020000020000020710020000020627020627020000020000020000020000020000020000020000020000020000020000020000020000020000020000020000020000020000020000020000020000020000020000020000020000020000020000
020000020000020000020000020000020000020000020000020000020627020627020627020627020000020520020000020000020000020000020000020000020000020000020000020000020000020000020000020000020000020000020000020000020000020000020000020000020000020000020000
020000020000020000020000020000020000020000020000020627020627030318030318020000020520020000020000020000020000020000020000020000020000020000020000020000020000020000020000020000020000020000020000020000020000020000020000020000020000020000020000
020000020000020000020000020000020000020000020000020627030318030318000603020627020627020000020000020000020000020000020000020000020000020000020000020000020000020000020000020000020000020000020000020000020000020000020000020000020000020000020000
020000020000020000020000020000020000020000020000030318030318000603000603020627020627020520020000020000020000020000020000020000020000020000020000020000020000020000020000020000020000020000020000020000020000020000020000020000020000020000020000
020000020000020000020000020000020000020000020000030318030318030318030318030318020520030318020520020000020000020000020000020000020000020000020000020000020000020000020000020000020000020000020000020000020000020000020000020000020000020000020000
020000020000020000020000020000020000020000020000020000020000030318030318030318030318030318000603020520020000020000020000020000020000020000020000020000020000020000020000020000020000020000020000020000020000020000020000020000020000020000020000
020000020000020000020000020000020000020000020000020000020000000603020520020000020000020000020520000603020000020000020000020000020000020000020000020000020000020000020000020000020000020000020000020000020000020000020000020000020000020000020000
020000020000020000020000020000020000020000020000020000020000000603000603000603000603000603000603000603020520020000020000020000020000020000020000020000020000020000020000020000020000020000020000020000020000020000020000020000020000020000020000
020000020000020000020000020000020000020000020000020000020000000603000603000603000603020000020000020520001222001222020000020000020000020000020000020000020000020000020000020000020000020000020000020000020000020000020000020000020000020000020000
020000020000020000020000020000020000020000020000020000020000020000000603000603001222001222001222001222001222020000020000020000020000020000020000020000020000020000020000020000020000020000020000020000020000020000020000020000020000020000020000
020000020000020000020000020000020000020000020000020000020000020000020520000603001222001222001222001222001222020000020000020000020000020000020000020000020000020000020000020000020000020000020000020000020000020000020000020000020000020000020000
020000020000020000020000020000020000020000020000020000020000020000020520001718001718001222001222020520001222001222001222020000020000020000020000020000020000020000020000020000020000020000020000020000020000020000020000020000020000020000020000
020000020000020000020000020000020000020000020000001905020000020520020000001718001718001222001222001222001222020000020000020000020000020000020000020000020000020000020000020000020000020000020000020000020000020000020000020000020000020000020000
020000020000020000020000020000020000020000001905001905001905001905001905001718001718001718001718020520020520020520020000020000020000020000020000020000020000020000020000020000020000020000020000020000020000020000020000020000020000020000020000
020000020000020000020000020000020000020000020000020000020000001905001905001905001905001905001905020000020000020520020520020000020000020000020000020000020000020000020000020000020000020000020000020000020000020000020000020000020000020000020000
020000020000020000020000020000020000020000020000020000020000020520020000020000001905001905001905001905020520020000020000020000020000020000020000020000020000020000020000020000020000020000020000020000020000020000020000020000020000020000020000
020000020000020000020000020000020000020000020000020000020000020520020520020520020520020520020000020000020000020000020000020000020000020000020000020000020000020000020000020000020000020000020000020000020000020000020000020000020000020000020000
020000020000020000020000020000020000020000020000020000020000020000020000020000020000020000020000020000020000020000020000020000020000020000020000020000020000020000020000020000020000020000020000020000020000020000020000020000020000020000020000
020000020000020000020000020000020000020000020000020000020000020000020000020000020000020000020000020000020000020000020000020000020000020000020000020000020000020000020000020000020000020000020000020000020000020000020000020000020000020000020000
020000020000020000020000020000020000020000020000020000020000020000020000020000020000020000020000020000020000020000020000020000020000020000020000020000020000020000020000020000020000020000020000020000020000020000020000020000020000020000020000
020000020000020000020000020000020000020000020000020000020000020000020000020000020000020000020000020000020000020000020000020000020000020000020000020000020000020000020000020000020000020000020000020000020000020000020000020000020000020000020000
020000020000020000020000020000020000020000020000020000020000020000020000020000020000020000020000020000020000020000020000020000020000020000020000020000020000020000020000020000020000020000020000020000020000020000020000020000020000020000020000
020000020000020000020000020000020000020000020000020000020000020000020000020000020000020000020000020000020000020000020000020000020000020000020000020000020000020000020000020000020000020000020000020000020000020000020000020000020000020000020000
020000020000020000020000020000020000020000020000020000020000020000020000020000020000020000020000020000020000020000020000020000020000020000020000020000020000020000020000020000020000020000020000020000020000020000020000020000020000020000020000
020000020000020000020000020000020000020000020000020000020000020000020000020000020000020000020000020000020000020000020000020000020000020000020000020000020000020000020000020000020000020000020000020000020000020000020000020000020000020000020000
020000020000020000020000020000020000020000020000020000020000020000020000020000020000020000020000020000020000020000020000020000020000020000020000020000020000020000020000020000020000020000020000020000020000020000020000020000020000020000020000
020000020000020000020000020000020000020000020000020000020000020000020000020000020000020000020000020000020000020000020000020000020000020000020000020000020000020000020000020000020000020000020000020000020000020000020000020000020000020000020000
020000020000020000020000020000020000020000020000020000020000020000020000020000020000020000020000020000020000020000020000020000020000020000020000020000020000020000020000020000020000020000020000020000020000020000020000020000020000020000020000
020000020000020000020000020000020000020000020000020000020000020000020000020000020000020000020000020000020000020000020000020000020000020000020000020000020000020000020000020000020000020000020000020000020000020000020000020000020000020000020000
