40
40
0200000020000002000000200000020000002000000200000020000002000000200000020000002000000200000020000002000000200000020000002000000200000020000002000000200000020000002000000200000020000002000000200000020000002000000200000020000002000000200000020000002000000200000020000002000000200000
0200000020000002000000200000020000002000000200000020000002000000200000020000002000000200000020000002000000200000020000002000000200000020000002000000200000020000002000000200000020000002000000200000020000002000000200000020000002000000200000020000002000000200000020000002000000200000
0200000020000002000000200000020000002000000200000020000002000000200000020000002000000200000020000002000000200000020000002000000200000020000002000000200000020000002000000200000020000002000000200000020000002000000200000020000002000000200000020000002000000200000020000002000000200000
0200000020000002000000200000020000002000000200000020000002000000200000020000002000000200000020000002000000200000020000002000000200000020000002000000200000020000002000000200000020000002000000200000020000002000000200000020000002000000200000020000002000000200000020000002000000200000
0200000020000002000000200000020000002000000200000020000002000000200000020000002000000200000020000002000000200000020000002000000200000020000002000000200000020000002000000200000020000002000000200000020000002000000200000020000002000000200000020000002000000200000020000002000000200000
0200000020000002000000200000020000002000000200000020000002000000200000020000002000000200000020000002000000200000020000002000000200000020000002000000200000020000002000000200000020000002000000200000020000002000000200000020000002000000200000020000002000000200000020000002000000200000
0200000020000002000000200000020000002000000200000020000002000000200000020000002000000200000020000002000000200000020000002000000200000020000002000000200000020000002000000200000020000002000000200000020000002000000200000020000002000000200000020000002000000200000020000002000000200000
0200000020000002000000200000020000002000000200000020000002000000200000020000002000000200000020000002000000200000020000002000000200000020000002000000200000020000002000000200000020000002000000200000020000002000000200000020000002000000200000020000002000000200000020000002000000200000
0200000020000002000000200000020000002000000200000020000002000000200000020000002000000200000020000002000000200000020000002000000200000020000002000000200000020000002000000200000020000002000000200000020000002000000200000020000002000000200000020000002000000200000020000002000000200000
0200000020000002000000200000020000002000000200000020000002000000200000020000002000000200000020000002000000200000020000002000000200000020000002000000200000020000002000000200000020000002000000200000020000002000000200000020000002000000200000020000002000000200000020000002000000200000
0200000020000002000000200000020000002000000200000020000002000000200000020000002000000200000020000002000000200000020000002000000200000020000002000000200000020000002000000200000020000002000000200000020000002000000200000020000002000000200000020000002000000200000020000002000000200000
0200000020000002000000200000020000002000000200000020000002000000200000020000002000000200000020000002000000200000020000002000000200000020000002000000200000020000002000000200000020000002000000200000020000002000000200000020000002000000200000020000002000000200000020000002000000200000
0200000020000002000000200000020000002000000200000020000002000000200000020000002000000200000020000002000000200000020000002000000200000020000002000000200000020000002000000200000020000002000000200000020000002000000200000020000002000000200000020000002000000200000020000002000000200000
0200000020000002000000200000020000002000000200000020000002000000200000020000002000000200000020000002000000200000020000002000000200000020000002000000200000020000002000000200000020000002000000200000020000002000000200000020000002000000200000020000002000000200000020000002000000200000
0200000020000002000000200000020000002141400214140020000002000000200000020000002000000200000020000002000000200000020000002000000200000020000002000000200000020000002000000200000020000002000000200000020000002000000200000020000002000000200000020000002000000200000020000002000000200000
0200000020000002000000200000020000002141400200000020000002000000200000020000002000000200000020000002000000200000020000002000000200000020000002000000200000020000002000000200000020000002000000200000020000002000000200000020000002000000200000020000002000000200000020000002000000200000
0200000020000002000000200000020000002141400214140021414002141400214140021414002000000200000020000002000000200000020000002000000200000020000002000000200000020000002000000200000020000002000000200000020000002000000200000020000002000000200000020000002000000200000020000002000000200000
0200000020000002000000200000020000002141400214140021414002141400214140021414002000000200000020000002000000200000020000002000000200000020000002000000200000020000002000000200000020000002000000200000020000002000000200000020000002000000200000020000002000000200000020000002000000200000
0200000020000002000000200000020000002000000214140021414002141400214140020000002000000200000020000002000000200000020000002000000200000020000002000000200000020000002000000200000020000002000000200000020000002000000200000020000002000000200000020000002000000200000020000002000000200000
0200000020000002000000200000020000002000000200000020000002000000200000020000002000000200000020000002000000200000020000002000000200000020000002000000200000020000002000000200000020000002000000200000020000002000000200000020000002000000200000020000002000000200000020000002000000200000
0200000020000002000000200000020000002000000200000020000002000000200000020000002000000200000020000002000000200000020000002000000200000020000002000000200000020000002000000200000020000002000000200000020000002000000200000020000002000000200000020000002000000200000020000002000000200000
0200000020000002000000200000020000002000000200000020000002000000200000020000002000000200000020000002000000200000020000002000000200000020000002000000200000020000002000000200000020000002000000200000020000002000000200000020000002000000200000020000002000000200000020000002000000200000
0200000020000002000000200000020000002000000200000020000002000000200000020000002000000200000020000002000000200000020000002000000200000020000002000000200000020000002000000200000020000002000000200000020000002000000200000020000002000000200000020000002000000200000020000002000000200000
0200000020000002000000200000020000002000000200000020000002000000200000020000002000000200000020000002000000200000020000002000000200000020000002000000200000020000002000000200000020000002000000200000020000002000000200000020000002000000200000020000002000000200000020000002000000200000
0200000020000002000000200000020000002000000200000020000002000000200000020000002000000200000020000002000000200000020000002000000200000020000002000000200000020000002000000200000020000002000000200000020000002000000200000020000002000000200000020000002000000200000020000002000000200000
0200000020000002000000200000020000002000000200000020000002000000200000020000002000000200000020000002000000200000020000002000000200000020000002000000200000020000002000000200000020000002000000200000020000002000000200000020000002000000200000020000002000000200000020000002000000200000
0200000020000002000000200000020000002000000200000020000002000000200000020000002000000200000020000002000000200000020000002000000200000020000002000000200000020000002000000200000020000002000000200000020000002000000200000020000002000000200000020000002000000200000020000002000000200000
0200000020000002000000200000020000002000000200000020000002000000200000020000002000000200000020000002000000200000020000002000000200000020000002000000200000020000002000000200000020000002000000200000020000002000000200000020000002000000200000020000002000000200000020000002000000200000
0200000020000002000000200000020000002000000200000020000002000000200000020000002000000200000020000002000000200000020000002000000200000020000002000000200000020000002000000200000020000002000000200000020000002000000200000020000002000000200000020000002000000200000020000002000000200000
0200000020000002000000200000020000002000000200000020000002000000200000020000002000000200000020000002000000200000020000002000000200000020000002000000200000020000002000000200000020000002000000200000020000002000000200000020000002000000200000020000002000000200000020000002000000200000
0200000020000002000000200000020000002000000200000020000002000000200000020000002000000200000020000002000000200000020000002000000200000020000002000000200000020000002000000200000020000002000000200000020000002000000200000020000002000000200000020000002000000200000020000002000000200000
0200000020000002000000200000020000002000000200000020000002000000200000020000002000000200000020000002000000200000020000002000000200000020000002000000200000020000002000000200000020000002000000200000020000002000000200000020000002000000200000020000002000000200000020000002000000200000
0200000020000002000000200000020000002000000200000020000002000000200000020000002000000200000020000002000000200000020000002000000200000020000002000000200000020000002000000200000020000002000000200000020000002000000200000020000002000000200000020000002000000200000020000002000000200000
0200000020000002000000200000020000002000000200000020000002000000200000020000002000000200000020000002000000200000020000002000000200000020000002000000200000020000002000000200000020000002000000200000020000002000000200000020000002000000200000020000002000000200000020000002000000200000
0200000020000002000000200000020000002000000200000020000002000000200000020000002000000200000020000002000000200000020000002000000200000020000002000000200000020000002000000200000020000002000000200000020000002000000200000020000002000000200000020000002000000200000020000002000000200000
0200000020000002000000200000020000002000000200000020000002000000200000020000002000000200000020000002000000200000020000002000000200000020000002000000200000020000002000000200000020000002000000200000020000002000000200000020000002000000200000020000002000000200000020000002000000200000
0200000020000002000000200000020000002000000200000020000002000000200000020000002000000200000020000002000000200000020000002000000200000020000002000000200000020000002000000200000020000002000000200000020000002000000200000020000002000000200000020000002000000200000020000002000000200000
0200000020000002000000200000020000002000000200000020000002000000200000020000002000000200000020000002000000200000020000002000000200000020000002000000200000020000002000000200000020000002000000200000020000002000000200000020000002000000200000020000002000000200000020000002000000200000
0200000020000002000000200000020000002000000200000020000002000000200000020000002000000200000020000002000000200000020000002000000200000020000002000000200000020000002000000200000020000002000000200000020000002000000200000020000002000000200000020000002000000200000020000002000000200000
0200000020000002000000200000020000002000000200000020000002000000200000020000002000000200000020000002000000200000020000002000000200000020000002000000200000020000002000000200000020000002000000200000020000002000000200000020000002000000200000020000002000000200000020000002000000200000
