40
40
020000020000020000020000000103020000020000020000020000020000020000020000020000020000020000020000020000020000020000020000020000020000020000020000020000020000020000020000020000020000020000020000020000020000020000020000020000020000020000020000
020000020000020000020000000103020000020000020000020000020000020000020000020000020000020000020000020000020000020000020000020000020000020000020000020000020000020000020000020000020000020000020000020000020000020000020000020000020000020000020000
020000000202000202000202000202020000020000020000020000020000020000020000020000020000020000020000020000020000020000020000020000020000020000020000020000020000020000020000020000020000020000020000020000020000020000020000020000020000020000020000
020000020000020000020000020000020000020000020000020000020000020000020000020000020000020000020000020000020000020000020000020000020000020000020000020000020000020000020000020000020000020000020000020000020000020000020000020000020000020000020000
020000020000020000010436010436010436010436010436010436010436010436020000020000020000020000020000020000020000020000020000020000020000020000020000020000020000020000020000020000020000020000020000020000020000020000020000020000020000020000020000
020000020000020000020000020000020000020000020000020000020000020000020000020000020000020000020000020000020000020000020000020000020000020000020000020000020000020000020000020000020000020000020000020000020000020000020000020000020000020000020000
000509000509000509000509000509000509000509020000020000020000020000020000020000020000020000020000020000020000020000020000020000020000020000020000020000020000020000020000020000020000020000020000020000020000020000020000020000020000020000020000
020000020000020000020000020000020000000509000509020000020000020000020000020000020000020000020000020000020000020000020000020000020000020000020000020000020000020000020000020000020000020000020000020000020000020000020000020000020000020000020000
020000020000020000020000020000020000020000000509020000020000020000020000020000020000020000020000020000020000020000020000020000020000020000020000020000020000020000020000020000020000020000020000020000020000020000020000020000020000020000020000
020000020000020000020000020000020000020000000509000509000509000509000509000509020000020000020000020000020000020000020000020000020000020000020000020000020000020000020000020000020000020000020000020000020000020000020000020000020000020000020000
020000020000020000020000020000020000010402020000020000020000020000020000000509000509020000020000020000020000020000020000020000020000020000020000020000020000020000020000020000020000020000020000020000020000020000020000020000020000020000020000
020000020000020000020000020000020000010402020000020000020000020000020000000509020000010402020000020000020000020000020000020000020000020000020000020000020000020000020000020000020000020000020000020000020000020000020000020000020000020000020000
020000020000020000020000020000020000010402020000020000020000020000000509000509020000010402020000020000020000020000020000020000020000020000020000020000020000020000020000020000020000020000020000020000020000020000020000020000020000020000020000
020000020000020000020000020000020000010402010402010402010402010402010402010402010402010402020000020000020000020000020000020000020000020000020000020000020000020000020000020000020000020000020000020000020000020000020000020000020000020000020000
020000020000020000020000020000020000020000020000020000020000020000020000020000020000020000020000020000020000020000020000020000020000020000020000020000020000020000020000020000020000020000020000020000020000020000020000020000020000020000020000
020000020000020000020000020000020000020000010402020000020000020000020000020000020000020000020000020000020000020000020000020000020000020000020000020000020000020000020000020000020000020000020000020000020000020000020000020000020000020000020000
011733011734011734011734011734011734011734011734011734011734011735020000020000020000020000020000020000020000013736013736020000020000020000020000020000020000020000020000020000020000020000020000020000020000020000020000020000020000020000020000
011833011633011834011834011834011834011834010402020000020000011835020000020000020000020000020000013736020000013736020000020000020000020000020000020000020000020000020000020000020000020000020000020000020000020000020000020000020000020000020000
011833011834011834011834011834011834011834011834020000020000011835011634020000020000020000013736013736020000013736020000020000020000020000020000020000020000020000020000020000020000020000020000020000020000020000020000020000020000020000020000
011833011834011834011834011834011834011834011834020000020000011835011634020000020000013736013736020000020000013736020000020000020000020000020000020000020000020000020000020000020000020000020000020000020000020000020000020000020000020000020000
011833020000011834011834011834011834011834010504020000020000011835020000020000020000013736013736020000020000013736020000020000020000020000020000020000020000020000020000020000020000020000020000020000020000020000020000020000020000020000020000
011833020000020000011834011834011834010504020000020000020000011835020000020000020000013736013736013736020000013736020000020000020000020000020000020000020000020000020000020000020000020000020000020000020000020000020000020000020000020000020000
011833020000020000020000010504020000020000020000020000020000011835011835020000020000013736013736020000013736013736020000020000020000020000020000020000020000020000020000020000020000020000020000020000020000020000020000020000020000020000020000
011833020000020000020000020000010504020000020000020000020000011835011835020000020000013636013736013736013736020000020000020000020000020000020000020000020000020000020000020000020000020000020000020000020000020000020000020000020000020000020000
011833020000020000020000020000010504010504020000020000020000011835020000020000020000013636020000020000020000020000020000020000020000020000020000020000020000020000020000020000020000020000020000020000020000020000020000020000020000020000020000
011833020000020000020000020000020000010504010504020000020000011835020000020000020000013636013636013636013636013636013636013636013636020000020000020000020000020000020000020000020000020000020000020000020000020000020000020000020000020000020000
011933011934011934011934011934011934011934011934011934011934011935020000020000020000020000020000020000020000020000020000020000020000020000020000020000020000020000020000020000020000020000020000020000020000020000020000020000020000020000020000
020000020000020000020000020000020000020000020000020000020000020000020000020000020000020000020000020000020000020000020000020000020000020000020000020000020000020000020000020000020000020000020000020000020000020000020000020000020000020000020000
020000020000020000020000020000020000020000020000020000020000020000020000020000020000020000020000020000020000020000020000020000020000020000020000020000020000020000020000020000020000020000020000020000020000020000020000020000020000020000020000
020000020000020000020000020000020000020000020000020000020000020000020000020000020000020000020000020000020000020000020000020000020000020000020000020000020000020000020000020000020000020000020000020000020000020000020000020000020000020000020000
020000020000020000020000020000020000020000020000020000020000020000020000020000020000020000020000020000020000020000020000020000020000020000020000020000020000020000020000020000020000020000020000020000020000020000020000020000020000020000020000
020000020000020000020000020000020000020000020000020000020000020000020000020000020000020000020000020000020000020000020000020000020000020000020000020000020000020000020000020000020000020000020000020000020000020000020000020000020000020000020000
020000020000020000020000020000020000020000020000020000020000020000020000020000020000020000020000020000020000020000020000020000020000020000020000020000020000020000020000020000020000020000020000020000020000020000020000020000020000020000020000
020000020000020000020000020000020000020000020000020000020000020000020000020000020000020000020000020000020000020000020000020000020000020000020000020000020000020000020000020000020000020000020000020000020000020000020000020000020000020000020000
020000020000020000020000020000020000020000020000020000020000020000020000020000020000020000020000020000020000020000020000020000020000020000020000020000020000020000020000020000020000020000020000020000020000020000020000020000020000020000020000
020000020000020000020000020000020000020000020000020000020000020000020000020000020000020000020000020000020000020000020000020000020000020000020000020000020000020000020000020000020000020000020000020000020000020000020000020000020000020000020000
020000020000020000020000020000020000020000020000020000020000020000020000020000020000020000020000020000020000020000020000020000020000020000020000020000020000020000020000020000020000020000020000020000020000020000020000020000020000020000020000
020000020000020000020000020000020000020000020000020000020000020000020000020000020000020000020000020000020000020000020000020000020000020000020000020000020000020000020000020000020000020000020000020000020000020000020000020000020000020000020000
020000020000020000020000020000020000020000020000020000020000020000020000020000020000020000020000020000020000020000020000020000020000020000020000020000020000020000020000020000020000020000020000020000020000020000020000020000020000020000020000
020000020000020000020000020000020000020000020000020000020000020000020000020000020000020000020000020000020000020000020000020000020000020000020000020000020000020000020000020000020000020000020000020000020000020000020000020000020000020000020000
