63
51
09002007090020080900200709002006090020070900200609002007090020060900200709002006090020070900200609002007090020060900200709002006090020070900200609002007090020060900200709002006090020070900200609002007090020060900200709002006090020070900200809002009020-10-1020-10-1020-10-1020-10-1020-10-1020-10-1020-10-1020-10-1020-10-109002005090020060900200709002008090020070900200809002007090020080900200709002008090020070900200809002007090020080900200709002008090020070900200809002009020-10-1020-10-1020-10-1020-10-1
09003007090030080900300709003006090030070900300609003007090030060900300709003006090030070900300609003007090030060900300709003006090030070900300609003007090030060900300709003006090030070900300609003007090030060900300709003006090030070900300809003009020-10-1020-10-1020-10-1020-10-1020-10-1020-10-1020-10-1020-10-1020-10-109003005090030060900300709003008090030070900300809003007090030080900300709003008090030070900300809003007090030080900300709003008090030070900300809003009020-10-1020-10-1020-10-1020-10-1
09002007090020080900200709002006090020070900200609002007090020060900200709002006090020070900200609002007090020060900200709002006090020070900200609002007090020060900200709002006090020070900200609002007090020060900200709002006090020070900200809002009020-10-1020-10-1020-10-1020-10-1020-10-1020-10-1020-10-1020-10-1020-10-109002005090020060900200709002006090020070900200609002007090020060900200709002006090020070900200609002007090020060900200709002006090020070900200809002009020-10-1020-10-1020-10-1020-10-1
09003007090030080900100709000014090000150900300809003007090030080900300709003008090030070900300809003007090030080900300709003008090030070900300809003007090030080900300709003008090030070900300809003007090030080900300709003008090030070900300809003009020-10-1020-10-1020-10-1020-10-1020-10-1020-10-1020-10-1020-10-1020-10-109003005090030060900300709003008090030070900300809003007090030080900300709003008090030070900300809003007090030080900300709003008090030070900300809003009020-10-1020-10-1020-10-1020-10-1
09002007090020080900200709001014090010150900400809004007090040080900400709004008090040070900400809004007090040080900400709004008090040070900400809004007090040080900400709004008090040070900400809004007090040080900400709004008090040070900400809004009020-10-1020-10-1020-10-1020-10-1020-10-1020-10-1020-10-1020-10-1020-10-1090040050900400609004007090040080900400709004008090040070900400809004007090040080900400709004008090040070900400809004007090040080900400709004008020-10-1020-10-1020-10-1020-10-1020-10-1
0900300709003008090010070900300809003009020-10-1020-10-1020-10-1020-10-1020-10-1020-10-1020-10-1020-10-1020-10-1020-10-1020-10-1020-10-1020-10-1020-10-1020-10-1020-10-1020-10-1020-10-1020-10-1020-10-1020-10-1020-10-1020-10-1020-10-1000-10-109006009020-10-1020-10-1020-10-1020-10-1020-10-1020-10-1020-10-1020-10-1020-10-1020-10-1020-10-1020-10-1020-10-1020-10-1020-10-1020-10-1020-10-1020-10-1020-10-1020-10-1020-10-1020-10-1020-10-1020-10-1020-10-1020-10-1020-10-1020-10-1020-10-1020-10-1020-10-1020-10-1
0900200709002008090020070900200809002009020-10-1020-10-1020-10-1020-10-1020-10-1020-10-1020-10-1020-10-1020-10-1020-10-1020-10-1020-10-1020-10-1020-10-1020-10-1020-10-1020-10-1020-10-1020-10-1020-10-1020-10-1020-10-1020-10-1020-10-1020-10-1020-10-1020-10-1020-10-1020-10-1020-10-1020-10-1020-10-1020-10-1020-10-1020-10-1020-10-1020-10-1020-10-1020-10-1020-10-1020-10-1020-10-1020-10-1020-10-1020-10-1020-10-1020-10-1020-10-1020-10-1020-10-1020-10-1020-10-1020-10-1020-10-1020-10-1020-10-1020-10-1020-10-1
0900300709003008090010070900300809003009020-10-1020-10-1020-10-1020-10-1020-10-1020-10-1020-10-1020-10-1020-10-1020-10-1020-10-1020-10-1020-10-1020-10-1020-10-1020-10-1020-10-1020-10-1020-10-1020-10-1020-10-1020-10-1020-10-1020-10-1020-10-1020-10-1020-10-1020-10-1020-10-1020-10-1020-10-1020-10-1020-10-1020-10-1020-10-1020-10-1020-10-1020-10-1020-10-1020-10-1020-10-1020-10-1020-10-1020-10-1020-10-1020-10-1020-10-1020-10-1020-10-1020-10-1020-10-1020-10-1020-10-1020-10-1020-10-1020-10-1020-10-1020-10-1
0900200709002008090020070900200809002009020-10-1020-10-1020-10-1020-10-1020-10-1020-10-1020-10-1020-10-1020-10-1020-10-1020-10-1020-10-1020-10-1020-10-1020-10-1020-10-1020-10-1020-10-1020-10-1020-10-1020-10-1020-10-1020-10-1020-10-1020-10-1020-10-1020-10-1020-10-1020-10-1020-10-1020-10-1020-10-1020-10-1020-10-1020-10-104004033040040340400403504004036020-10-104004033040040340400403504004036020-10-104004033040040340400403504004036020-10-1020-10-1020-10-1020-10-1020-10-1020-10-1020-10-1020-10-1020-10-1
0900300709003008090010070900300809003009020-10-1020-10-1020-10-1020-10-1020-10-100018022000180230001802400018025020-10-100018022000180230001802400018025020-10-100018022000180230001802400018025020-10-100018022000180230001802400018025020-10-1020-10-1020-10-1020-10-1020-10-1020-10-1020-10-1020-10-1020-10-1020-10-104005032040050330400503404005035040050360400503704005033040050340400503504005036040050370400503304005034040050350400503604005037020-10-1020-10-1020-10-1020-10-1020-10-1020-10-1020-10-1020-10-1
0900200709002008090020070900200809002009020-10-1020-10-1020-10-1020-10-1020-10-100019022000190230001902400019025020-10-100019022000190230001902400019025020-10-100019022000190230001902400019025020-10-100019022000190230001902400019025020-10-1020-10-1020-10-1020-10-1020-10-1020-10-1020-10-1020-10-1020-10-1020-10-104006032040060330400603404006035040060360400603704006033040060340400603504006036040060370400603304006034040060350400603604006037020-10-1020-10-1020-10-1020-10-1020-10-1020-10-1020-10-1020-10-1
0900300709003008090010070900300809003009020-10-1020-10-1020-10-1020-10-1020-10-100020022000200230002002400020025020-10-100020022000200230002002400020025020-10-100020022000200230002002400020025020-10-100020022000200230002002400020025020-10-1020-10-1020-10-1020-10-1020-10-1020-10-1020-10-1020-10-1020-10-1020-10-10400703204007033020-10-1020-10-1040070360400703704007033040-10-1020-10-1040070360400703704007033020-10-1040-10-10400703604007037020-10-1020-10-1020-10-1020-10-1020-10-1020-10-1020-10-1020-10-1
0900200709002008090020070900200809002009020-10-1020-10-1020-10-1020-10-1020-10-1020-10-1020-10-1020-10-1020-10-1020-10-1020-10-1020-10-1020-10-1020-10-1020-10-1020-10-1020-10-1020-10-1020-10-1020-10-1020-10-1020-10-1020-10-1020-10-1020-10-1020-10-1020-10-1020-10-1020-10-1020-10-1020-10-1020-10-1020-10-1020-10-1020-10-1020-10-1020-10-1020-10-1020-10-1020-10-1040-10-1020-10-1020-10-1020-10-1020-10-1020-10-1020-10-1020-10-1020-10-1020-10-1020-10-1020-10-1020-10-1020-10-1020-10-1020-10-1020-10-1020-10-1
0900300709003008090010070900300809003009020-10-1020-10-1020-10-1020-10-1020-10-1020-10-1020-10-1020-10-1020-10-1020-10-1020-10-1020-10-1020-10-1020-10-1020-10-1020-10-1020-10-1020-10-1020-10-1020-10-1020-10-1020-10-1020-10-1020-10-1020-10-1020-10-1020-10-1020-10-1020-10-1020-10-1020-10-1020-10-1020-10-1020-10-1020-10-1020-10-1020-10-100042024000420250004202600042027020-10-100042024000420250004202600042027020-10-1020-10-1020-10-1020-10-1020-10-1020-10-1020-10-1020-10-1020-10-1020-10-1020-10-1020-10-1
0900200709002008090020070900200809002009020-10-1020-10-1020-10-1020-10-1020-10-1020-10-1020-10-1020-10-1020-10-1020-10-1020-10-1020-10-1020-10-1020-10-1020-10-1020-10-1020-10-1020-10-1020-10-1020-10-1020-10-1020-10-1020-10-1020-10-1020-10-1020-10-1020-10-1020-10-1020-10-1020-10-1020-10-1020-10-1020-10-1020-10-1020-10-1020-10-1020-10-100043024000430250004302600044027020-10-100043024000430250004302600043027020-10-1020-10-1020-10-1020-10-1020-10-1020-10-1020-10-1020-10-1020-10-1020-10-1020-10-1020-10-1
0900300709003008090010070900300809003009020-10-1020-10-1020-10-1020-10-1020-10-1020-10-1020-10-1020-10-1020-10-1020-10-1020-10-1020-10-1020-10-1020-10-1020-10-1020-10-1020-10-1020-10-1020-10-1020-10-1020-10-1020-10-1020-10-1020-10-1020-10-1020-10-1020-10-1020-10-1020-10-1020-10-1020-10-1020-10-1020-10-1020-10-1020-10-1020-10-1020-10-100044024000440250004402600044027020-10-100044024000440250004402600044027020-10-1020-10-1020-10-1020-10-1020-10-1020-10-1020-10-1020-10-1020-10-1020-10-1020-10-1020-10-1
0900200709002008090020070900200809002009020-10-1020-10-1020-10-1020-10-1020-10-1020-10-104004046020-10-1020-10-1020-10-1020-10-1020-10-1020-10-1020-10-1020-10-1020-10-1020-10-1020-10-1020-10-10004201000042011000420120004201300042014020-10-1020-10-1020-10-1020-10-1020-10-1020-10-1020-10-1020-10-1020-10-1020-10-1020-10-1020-10-1020-10-100045024000450250004502600045027020-10-100045024000450250004502600045027020-10-1020-10-1020-10-1020-10-1020-10-1020-10-1020-10-1020-10-1020-10-1020-10-1020-10-1020-10-1
0900300709003008090010070900300809003009020-10-1020-10-1020-10-1020-10-1020-10-104005045040050460400504704005048040050490400505004005051020-10-10405007304050074040500750405007604050077020-10-10004301000043011000430120004301300043014020-10-1020-10-1020-10-1020-10-1040630900406309104063092020-10-1020-10-1020-10-1020-10-1020-10-1020-10-100046024000460250004602600046027020-10-100046024000460250004602600046027020-10-1020-10-1020-10-1020-10-1020-10-1020-10-1020-10-1020-10-1020-10-1020-10-1020-10-1020-10-1
0900200709002008090020070900200809002009020-10-1020-10-1020-10-1020-10-1020-10-104006045040060460400604704006048040060490400605004006051020-10-10405107304051074040510750405107604051077020-10-10004401000044011000440120004401300044014020-10-1020-10-1040640880406408904064090040640910406409204064093020-10-1020-10-1020-10-1020-10-1020-10-1020-10-1020-10-1020-10-1020-10-1020-10-1020-10-1020-10-1020-10-1020-10-1020-10-1020-10-1020-10-1020-10-1020-10-1020-10-1020-10-1020-10-1020-10-1020-10-1020-10-1020-10-1
0900300709003008090010070900300809003009020-10-1020-10-1020-10-1020-10-1020-10-104007045040070460400704704007048040070490400705004007051020-10-1020-10-1020-10-1020-10-1020-10-1020-10-1020-10-10004501000045011000450120004501300045014020-10-1020-10-104065088040650890406509004065091040650920406509304065094020-10-1020-10-1020-10-1020-10-1020-10-1020-10-1020-10-1020-10-1020-10-1020-10-1020-10-1020-10-1020-10-1020-10-1020-10-1020-10-1020-10-1020-10-1020-10-1020-10-1020-10-1020-10-1020-10-1020-10-1020-10-1
0900200709002008090020070900200809002009020-10-1020-10-1020-10-1020-10-1020-10-1040080450400804604008047020-10-1020-10-10400805004008051020-10-1020-10-1020-10-1020-10-1020-10-1020-10-1020-10-1020-10-1020-10-1020-10-1020-10-1020-10-1020-10-1020-10-104066088040660890406609004066091040660920406609304066094020-10-1020-10-1020-10-1020-10-1020-10-1020-10-1020-10-1020-10-1020-10-1020-10-1020-10-1020-10-1020-10-1020-10-1020-10-1020-10-1020-10-1020-10-1020-10-1020-10-1020-10-1020-10-1020-10-1020-10-1020-10-1
0900300709003008090030070900300809003009020-10-1020-10-1020-10-1020-10-1020-10-1020-10-1020-10-1020-10-1020-10-1020-10-1020-10-1020-10-1020-10-1020-10-1040550740405507504055076020-10-1020-10-1020-10-1020-10-1020-10-1020-10-1020-10-1020-10-1020-10-104067088040670890406709004067091040670920406709304067094020-10-1020-10-1020-10-1020-10-1020-10-1020-10-1020-10-1020-10-1020-10-1020-10-1020-10-1020-10-1020-10-1020-10-1020-10-1020-10-1020-10-1020-10-1020-10-1020-10-1020-10-1020-10-1020-10-1020-10-1020-10-1
09004007090040080900400709004008020-10-1020-10-1020-10-1020-10-1020-10-1020-10-1020-10-1020-10-1020-10-1020-10-1020-10-1020-10-1020-10-1020-10-1020-10-1020-10-1020-10-1020-10-1020-10-1020-10-1020-10-1020-10-1020-10-1020-10-1020-10-1020-10-1020-10-104068088040680890406809004068091040680920406809304068094020-10-1020-10-1020-10-1020-10-1020-10-1020-10-1020-10-1020-10-1020-10-1020-10-1020-10-1020-10-1020-10-1020-10-1020-10-1020-10-1020-10-1020-10-1020-10-1020-10-1020-10-1020-10-1020-10-1020-10-1020-10-1
020-10-1020-10-1020-10-1020-10-1020-10-1020-10-1020-10-1020-10-1020-10-1020-10-1020-10-1020-10-1020-10-1020-10-1020-10-1020-10-1020-10-1020-10-1020-10-1020-10-1020-10-1020-10-1020-10-1020-10-1020-10-1020-10-1020-10-1020-10-1020-10-1020-10-1020-10-104069088040690890406909004069091040690920406909304069094020-10-1020-10-1020-10-1020-10-1020-10-1020-10-1020-10-1020-10-1020-10-1020-10-1020-10-1020-10-1020-10-1020-10-1020-10-1020-10-1020-10-1020-10-1020-10-1020-10-1020-10-1020-10-1020-10-1020-10-1020-10-1
020-10-1020-10-1020-10-1020-10-1020-10-1020-10-1020-10-1020-10-1020-10-1020-10-1020-10-1020-10-1020-10-1020-10-1020-10-1020-10-1020-10-1020-10-1020-10-1020-10-1020-10-1020-10-1020-10-1020-10-1020-10-1020-10-1020-10-1020-10-1020-10-1020-10-1020-10-104070088040700890407009004070091040700920407009304070094020-10-1020-10-1020-10-1020-10-1020-10-1020-10-1020-10-1020-10-1020-10-1020-10-1020-10-1020-10-1020-10-1020-10-1020-10-1020-10-1020-10-1020-10-1020-10-1020-10-1020-10-1020-10-1020-10-1020-10-1020-10-1
020-10-1020-10-1020-10-1020-10-1020-10-1020-10-1020-10-1020-10-1020-10-1020-10-1020-10-1020-10-1020-10-1020-10-1020-10-1020-10-1020-10-1020-10-1020-10-1020-10-1020-10-1020-10-1020-10-1020-10-1020-10-1020-10-1000150150001501600015017020-10-1020-10-104071088020-10-1020-10-1020-10-1020-10-1020-10-1020-10-1020-10-1020-10-1000040220000402300004024020-10-1020-10-1020-10-1020-10-1040040400400404104004042020-10-1020-10-1020-10-1020-10-1020-10-1020-10-1020-10-1020-10-1020-10-1020-10-1020-10-1020-10-1020-10-1
020-10-1020-10-1020-10-1020-10-1020-10-1020-10-1020-10-1020-10-1020-10-1020-10-1000150010001500200015003000150040001500500015006000150070001500800015009020-10-1020-10-1020-10-1020-10-1020-10-1020-10-10001601400016015000160160001601700016018020-10-104072088020-10-1020-10-1020-10-1020-10-1020-10-1020-10-1020-10-10000502100005022000050230000502400005025000-10-1020-10-1040050390400504004005041040050420400504304005044020-10-1020-10-1020-10-1020-10-1020-10-1020-10-1020-10-1020-10-1020-10-1020-10-1020-10-1
020-10-1020-10-1020-10-1020-10-1020-10-1020-10-1020-10-1020-10-1020-10-1020-10-1000160010001600200016003000160040001600500016006000160070001600800016009000040010000400200004003000040040000400500017013000170140001701500017016000170170001701800017019020-10-1020-10-1020-10-1020-10-1020-10-1020-10-1020-10-10000602000006021000060220000602300006024000060250000602604006038040060390400604004006041040060420400604304006044020-10-1020-10-1020-10-1020-10-1020-10-1020-10-1020-10-1020-10-1020-10-1020-10-1020-10-1
020-10-1020-10-1020-10-1020-10-1020-10-1020-10-1020-10-1020-10-1020-10-1020-10-1000170010001700200017003000170040001700500017006000170070001700800017009000050010000500200005003000050040000500500018013000180140001801500018016000180170001801800018019020-10-1020-10-1020-10-1020-10-1020-10-1020-10-1020-10-10000702000007021000070220000702300007024000070250000702604007038040070390400704004007041040070420400704304007044020-10-1020-10-1020-10-1020-10-1020-10-1020-10-1020-10-1020-10-1020-10-1020-10-1020-10-1
020-10-1020-10-1020-10-1020-10-1020-10-1020-10-1020-10-1020-10-1020-10-1020-10-10001800100018002000180030001800400018005000180060001800700018008000180090000600100006002000060030000600400006005000190130001901400019015020-10-1000190170001901800019019020-10-1020-10-1020-10-1020-10-1020-10-1020-10-1020-10-1000080200000802100008022020-10-100008024000080250000802604008038040080390400804004008041040080420400804304008044020-10-1020-10-1020-10-1020-10-1020-10-1020-10-1020-10-1020-10-1020-10-1020-10-1020-10-1
020-10-1020-10-1020-10-1020-10-1020-10-1020-10-1020-10-1020-10-1020-10-1020-10-1020-10-1020-10-1020-10-1000190040001900500019006020-10-1020-10-1020-10-1000070010000700200007003000070040000700500020013020-10-1020-10-1020-10-1020-10-10002001800020019020-10-1020-10-1020-10-1020-10-1020-10-1020-10-1020-10-100009020020-10-1020-10-1020-10-1020-10-100009025000090260400903804009039020-10-1020-10-1020-10-10400904304009044020-10-1020-10-1020-10-1020-10-1020-10-1020-10-1020-10-1020-10-1020-10-1020-10-1020-10-1
020-10-1020-10-1020-10-1020-10-1020-10-1020-10-1020-10-1020-10-1020-10-1020-10-1020-10-1020-10-1020-10-1020-10-1020-10-1020-10-1020-10-1020-10-1020-10-1020-10-1020-10-1020-10-1020-10-1020-10-1020-10-1020-10-1020-10-1020-10-1020-10-1020-10-1020-10-1020-10-1020-10-1020-10-1020-10-1020-10-1020-10-1020-10-1020-10-1020-10-1020-10-1020-10-1020-10-1020-10-1020-10-104010038020-10-1020-10-1020-10-1020-10-1020-10-104010044020-10-1020-10-1020-10-1020-10-1020-10-1020-10-1020-10-1020-10-1020-10-1020-10-1020-10-1
020-10-1020-10-1020-10-1020-10-1020-10-1020-10-1020-10-1020-10-1020-10-1020-10-1020-10-1020-10-1020-10-1020-10-1020-10-1020-10-1020-10-1020-10-1020-10-1020-10-1020-10-1020-10-1020-10-1020-10-1020-10-1020-10-1020-10-1020-10-1020-10-1020-10-1020-10-1020-10-1020-10-1020-10-1020-10-1020-10-1020-10-1020-10-1020-10-1020-10-1020-10-1020-10-1020-10-1020-10-1020-10-1020-10-1020-10-1020-10-1020-10-1020-10-1020-10-1020-10-1020-10-1020-10-1020-10-1020-10-1020-10-1020-10-1020-10-1020-10-1020-10-1020-10-1020-10-1
09000006090000070900000809000009020-10-1020-10-1020-10-1020-10-1020-10-1020-10-1020-10-1020-10-1020-10-1020-10-1020-10-1020-10-1020-10-1020-10-1020-10-1020-10-1020-10-1020-10-1020-10-1020-10-1020-10-1020-10-1020-10-1020-10-1020-10-1020-10-1020-10-1020-10-1020-10-1020-10-1020-10-1020-10-1020-10-1020-10-1020-10-1020-10-1020-10-1020-10-1020-10-1020-10-1020-10-1020-10-1020-10-1020-10-1020-10-1020-10-1020-10-1020-10-1020-10-1020-10-1020-10-1020-10-1020-10-1020-10-1020-10-1020-10-1020-10-1020-10-1020-10-1
09001006090010070900100809001009020-10-1020-10-1020-10-1020-10-1020-10-1020-10-1020-10-1020-10-1020-10-1020-10-1020-10-1020-10-1020-10-1020-10-1020-10-1020-10-1020-10-1020-10-1020-10-1020-10-1020-10-1020-10-1020-10-1020-10-1020-10-1020-10-1020-10-1020-10-1020-10-1020-10-1020-10-1020-10-1020-10-1020-10-1020-10-1020-10-1020-10-1020-10-1020-10-1020-10-1020-10-1020-10-1020-10-1020-10-1020-10-1020-10-1020-10-1020-10-1020-10-1020-10-1020-10-1020-10-1020-10-1020-10-1020-10-1020-10-1020-10-1020-10-1020-10-1
09002006090020070900200809002009020-10-1020-10-1020-10-1020-10-1020-10-1020-10-1020-10-10000401500004016020-10-1020-10-1020-10-10000401500004016020-10-1020-10-1020-10-10000401500004016020-10-1020-10-1020-10-10000401500004016020-10-1020-10-1020-10-1020-10-1020-10-1020-10-1020-10-1020-10-1020-10-1020-10-1020-10-1020-10-1020-10-10001702300017024020-10-1020-10-1020-10-10001702300017024020-10-1020-10-1020-10-10001702300017024020-10-1020-10-1020-10-1020-10-1020-10-1020-10-1020-10-1020-10-1020-10-1020-10-1
09001006090010070900100809001009020-10-1020-10-1020-10-1020-10-1020-10-1020-10-100005014000050150000501600005017020-10-100005014000050150000501600005017020-10-100005014000050150000501600005017020-10-100005014000050150000501600005017020-10-1020-10-1020-10-1020-10-1020-10-1020-10-1020-10-1020-10-1020-10-1020-10-1020-10-100018022000180230001802400018025020-10-100018022000180230001802400018025020-10-100018022000180230001802400018025020-10-1020-10-1020-10-1020-10-1020-10-1020-10-1020-10-1020-10-1020-10-1
09002006090020070900200809002009020-10-1020-10-1020-10-1020-10-1020-10-1020-10-100006014000060150000601600006017020-10-100006014000060150000601600006017020-10-100006014000060150000601600006017020-10-100006014000060150000601600006017020-10-1020-10-1020-10-1020-10-1020-10-1020-10-1020-10-1020-10-1020-10-1020-10-1020-10-100019022000190230001902400019025020-10-100019022000190230001902400019025020-10-100019022000190230001902400019025020-10-1020-10-1020-10-1020-10-1020-10-1020-10-1020-10-1020-10-1020-10-1
09001006090010070900100809001009020-10-1020-10-1020-10-1020-10-1020-10-1020-10-100007014000070150000701600007017020-10-100007014000070150000701600007017020-10-100007014000070150000701600007017020-10-100007014000070150000701600007017020-10-1020-10-1020-10-1020-10-1020-10-1020-10-1020-10-1020-10-1020-10-1020-10-1020-10-100020022000200230002002400020025020-10-100020022000200230002002400020025020-10-100020022000200230002002400020025020-10-1020-10-1020-10-1020-10-1020-10-1020-10-1020-10-1020-10-1020-10-1
09002006090020070900200809002009020-10-1020-10-1020-10-1020-10-1020-10-1020-10-1020-10-1020-10-1020-10-1020-10-1020-10-1020-10-1020-10-1020-10-1020-10-1020-10-1020-10-1020-10-1020-10-1020-10-1020-10-1020-10-1020-10-1020-10-1020-10-1020-10-1020-10-1020-10-1020-10-1020-10-1020-10-1020-10-1020-10-1020-10-1020-10-1020-10-1020-10-1020-10-1020-10-1020-10-1020-10-1020-10-1020-10-1020-10-1020-10-1020-10-1020-10-1020-10-1020-10-1020-10-1020-10-1020-10-1020-10-1020-10-1020-10-1020-10-1020-10-1020-10-1020-10-1
09001006090010070900100809001009020-10-1020-10-1020-10-1020-10-1020-10-1020-10-1020-10-1020-10-1020-10-1020-10-1020-10-1020-10-1020-10-1020-10-1020-10-1020-10-1020-10-1020-10-1020-10-1020-10-1020-10-1020-10-1020-10-1020-10-1020-10-1020-10-1020-10-1020-10-1020-10-1020-10-1020-10-1020-10-1020-10-1020-10-1020-10-1020-10-1020-10-1020-10-1020-10-1020-10-1020-10-1020-10-1020-10-1020-10-1020-10-1020-10-1020-10-1020-10-1020-10-1020-10-1020-10-1020-10-1020-10-1020-10-1020-10-1020-10-1020-10-1020-10-1020-10-1
09002006090020070900200809002009020-10-1020-10-1020-10-1020-10-1020-10-1020-10-1020-10-1020-10-1020-10-1020-10-1020-10-1020-10-1020-10-1020-10-1020-10-1020-10-1020-10-1020-10-1020-10-1020-10-1020-10-1020-10-1020-10-1020-10-1020-10-1020-10-1020-10-1020-10-1020-10-1020-10-1020-10-1020-10-1020-10-1020-10-1020-10-1020-10-1020-10-1020-10-1020-10-1020-10-1020-10-1020-10-1020-10-1020-10-1020-10-1020-10-1020-10-1020-10-1020-10-1020-10-1020-10-1020-10-1020-10-1020-10-1020-10-1020-10-1020-10-1020-10-1020-10-1
09001006090010070900100809001009020-10-1020-10-1020-10-1020-10-1020-10-1020-10-1020-10-1020-10-1020-10-1020-10-1020-10-1020-10-1020-10-1020-10-1020-10-1020-10-1020-10-1020-10-1020-10-1020-10-1020-10-1020-10-1020-10-1020-10-1020-10-1020-10-1020-10-1020-10-1020-10-1020-10-1020-10-1020-10-1020-10-1020-10-1020-10-1020-10-1020-10-1020-10-1020-10-1020-10-1020-10-1020-10-1020-10-1020-10-1020-10-1020-10-1020-10-1020-10-1020-10-1020-10-1020-10-1020-10-1020-10-1020-10-1020-10-1020-10-1020-10-1020-10-1020-10-1
09002006090020070900200809002009020-10-1020-10-1020-10-1020-10-1020-10-1020-10-1020-10-1020-10-1020-10-1020-10-1020-10-1020-10-1020-10-1020-10-1020-10-1020-10-1020-10-1020-10-1020-10-1020-10-1020-10-1020-10-1020-10-1020-10-1020-10-1020-10-1020-10-1020-10-1020-10-1020-10-1020-10-1020-10-1020-10-1020-10-1020-10-1020-10-1020-10-1020-10-1020-10-1020-10-1020-10-1020-10-1020-10-1020-10-1020-10-1020-10-1020-10-1020-10-1020-10-1020-10-1020-10-1020-10-1020-10-1020-10-1020-10-1020-10-1020-10-1020-10-1020-10-1
09001006090010070900100809001009020-10-1020-10-1020-10-1020-10-1020-10-1020-10-1020-10-1020-10-1020-10-1020-10-1020-10-1020-10-1020-10-1020-10-1020-10-1020-10-1020-10-1020-10-1020-10-1020-10-1020-10-1020-10-1020-10-1020-10-1020-10-1020-10-1020-10-1020-10-1020-10-1020-10-1020-10-1020-10-1020-10-1020-10-1020-10-1020-10-1020-10-1020-10-1020-10-1020-10-1020-10-1020-10-1020-10-1020-10-1020-10-1020-10-1020-10-1020-10-1020-10-1020-10-1020-10-1020-10-1020-10-1020-10-1020-10-1020-10-1020-10-1020-10-1020-10-1
09002006090020070900200809002009020-10-1020-10-1020-10-1020-10-1020-10-1020-10-1020-10-1020-10-1020-10-1020-10-1020-10-1020-10-1020-10-1020-10-1020-10-1020-10-1020-10-1020-10-1020-10-1020-10-1020-10-1020-10-1020-10-1020-10-1020-10-1020-10-1020-10-1020-10-1020-10-1020-10-1020-10-1020-10-1020-10-1020-10-1020-10-1020-10-1020-10-1020-10-1020-10-1020-10-1020-10-1020-10-1020-10-1020-10-1020-10-1020-10-1020-10-1020-10-1020-10-1020-10-1020-10-1020-10-1020-10-1020-10-1020-10-1020-10-1020-10-1020-10-1020-10-1
09001006090010070900001609000017020-10-1020-10-1020-10-1020-10-1020-10-1020-10-1020-10-1020-10-1020-10-1020-10-1020-10-1020-10-1020-10-1020-10-1020-10-1020-10-1020-10-1020-10-1020-10-1020-10-1020-10-1020-10-1020-10-1020-10-1020-10-1020-10-1020-10-1020-10-1020-10-1020-10-1020-10-1020-10-1020-10-1020-10-1020-10-1020-10-1020-10-1020-10-1020-10-1020-10-1020-10-1020-10-1020-10-1020-10-1020-10-1020-10-1020-10-1020-10-1020-10-1020-10-1020-10-1020-10-1020-10-1020-10-1020-10-1020-10-1020-10-1020-10-1020-10-1
0900200609002007090010160900101709000006090000070900000609000007090000060900000709000006090000070900000609000007090000060900000709000006090000070900000609000007090000060900000709000006090000070900000609000007090000060900000709000006090000070900000809000009020-10-1020-10-1020-10-1020-10-1020-10-1020-10-1020-10-109000005090000060900000709000008090000070900000609000007090000060900000709000006090000070900000609000007090000060900000709000006090000070900000809000009020-10-1020-10-1020-10-1020-10-1020-10-1
0900100609001007090010060900100709001006090010070900100609001007090010060900100709001006090010070900100609001007090010060900100709001006090010070900100609001007090010060900100709001006090010070900100609001007090010060900100709001006090010070900100809001009020-10-1020-10-1020-10-1020-10-1020-10-1020-10-1020-10-109001005090010060900100709001008090010070900100609001007090010060900100709001006090010070900100609001007090010060900100709001006090010070900100809001009020-10-1020-10-1020-10-1020-10-1020-10-1
0900200609002007090020060900200709002006090020070900200609002007090020060900200709002006090020070900200609002007090020060900200709002006090020070900200609002007090020060900200709002006090020070900200609002007090020060900200709002006090020070900200809002009020-10-1020-10-1020-10-1020-10-1020-10-1020-10-1020-10-109002005090020060900200709002006090020070900200609002007090020060900200709002006090020070900200609002007090020060900200709002006090020070900200809002009020-10-1020-10-1020-10-1020-10-1020-10-1
0900300609003007090030080900300709003008090030070900300809003007090030080900300709003008090030070900300809003007090030080900300709003008090030070900300809003007090030080900300709003008090030070900300809003007090030080900300709003008090030070900300809003009020-10-1020-10-1020-10-1020-10-1020-10-1020-10-1020-10-109003005090030060900100709001006090010070900100609001007090010060900100709001006090010070900100609001007090010060900100709001006090010070900300809003009020-10-1020-10-1020-10-1020-10-1020-10-1
