63
51
02007019020-10-1020-10-1020-10-1020-10-1020-10-1020-10-1020-10-1020-10-1020-10-1020-10-1020-10-1020-10-1020-10-1020-10-1020-10-1020-10-1020-10-1020-10-1020-10-1020-10-1020-10-1020-10-1020-10-1020-10-1020-10-1020-10-1020-10-1020-10-1020-10-1020-10-1020-10-1020-10-1020-10-1020-10-1020-10-1020-10-1020-10-1020-10-1020-10-10900500509005006020-10-1020-10-1020-10-1020-10-1020-10-1020-10-1020-10-1020-10-1020-10-1020-10-1020-10-1020-10-1020-10-1020-10-1020-10-1020-10-101004001020-10-1020-10-1020-10-1020-10-1
02007019020-10-1020-10-1020-10-1020-10-1020-10-1020-10-1020-10-1020-10-1020-10-1020-10-1020-10-1020-10-1020-10-1020-10-1020-10-1020-10-1020-10-1020-10-1020-10-1020-10-1020-10-1020-10-1020-10-1020-10-1020-10-1020-10-1020-10-1020-10-1020-10-1020-10-1020-10-1020-10-1020-10-1020-10-1020-10-1020-10-1020-10-1020-10-1020-10-10900600509006006020-10-1020-10-1020-10-1020-10-1020-10-1020-10-1020-10-1020-10-1020-10-1020-10-1020-10-1020-10-1020-10-1020-10-1020-10-1020-10-101004001020-10-1020-10-1020-10-1020-10-1
02007019020-10-1020-10-1020-10-1020-10-1020-10-1020-10-1020-10-1020-10-1020-10-1020-10-1020-10-1020-10-1020-10-1020-10-1020-10-1020-10-1020-10-1020-10-1020-10-1020-10-1020-10-1020-10-1020-10-1020-10-1020-10-1020-10-1020-10-1020-10-1000-10-1000-10-1020-10-1020-10-1020-10-1020-10-1020-10-1020-10-1020-10-1020-10-1020-10-10900500509005006090050070900500609005007090050060900500709005006090050070900500609005007090050060900500709005006090050070900500609005007020-10-101004001020-10-1020-10-1020-10-1020-10-1
02007019020-10-1020-10-1020-10-1020-10-1020-10-1020-10-1020-10-1020-10-1020-10-1020-10-1020-10-1020-10-1020-10-1020-10-1020-10-1020-10-1020-10-1020-10-1020-10-1020-10-1020-10-1020-10-1020-10-1020-10-1020-10-1020-10-1020-10-1020-10-1000-10-1000-10-1020-10-1020-10-1020-10-1020-10-1020-10-1020-10-1020-10-1020-10-1020-10-10900600509006006090060070900600609006007090060060900600709006006090060070900600609006007090060060900600709006006090060070900600609006007020-10-101004001020-10-1020-10-1020-10-1020-10-1
020-10-1020-10-1020-10-109005006090050070900500609005007090050060900500709005006090050070900500609005007090050060900500709005006090050070900500609005007090050060900500709005006090050070900500609005007090050060900500709005006090050070900500809005009020-10-1020-10-1020-10-1020-10-1020-10-1020-10-1020-10-1020-10-1020-10-109005005090050060900500709005006090050070900500609005007090050060900500709005006090050070900500609005007090050060900500709005006090050070900500801004001020-10-1020-10-1020-10-1020-10-1
020-10-1020-10-1020-10-109006006090060070900600609006007090060060900600709006006090060070900600609006007090060060900600709006006090060070900600609006007090060060900600709006006090060070900600609006007090060060900600709006006090060070900600809006009020-10-1020-10-1020-10-1020-10-1020-10-1020-10-1020-10-1020-10-1020-10-109006005090060060900600709006006090060070900600609006007090060060900600709006006090060070900600609006007090060060900600709006006090060070900600801004001020-10-1020-10-1020-10-1020-10-1
020-10-109005006090050070900500809005009020-10-1020-10-1020-10-1020-10-1020-10-1020-10-1020-10-1020-10-1020-10-1020-10-1020-10-1020-10-1020-10-1020-10-1020-10-1020-10-1020-10-1020-10-1020-10-1020-10-1020-10-1020-10-1020-10-1020-10-1020-10-1020-10-1020-10-1020-10-1020-10-1020-10-1020-10-1020-10-1020-10-1020-10-1020-10-1020-10-1020-10-1020-10-1020-10-1020-10-1020-10-1020-10-1020-10-1020-10-1020-10-1020-10-1020-10-1020-10-1020-10-1020-10-1020-10-1020-10-1020-10-101004001020-10-1020-10-1020-10-1020-10-1
020-10-109006006090060070900600809006009020-10-1020-10-1020-10-1020-10-1020-10-1020-10-1020-10-1020-10-1020-10-1020-10-1020-10-1020-10-1020-10-1020-10-1020-10-1020-10-1020-10-1020-10-1020-10-1020-10-1020-10-1020-10-1020-10-1020-10-1020-10-1020-10-1020-10-1020-10-1020-10-1020-10-1020-10-1020-10-1020-10-1020-10-1020-10-1020-10-1020-10-1020-10-1020-10-1020-10-1020-10-1020-10-1020-10-1020-10-1020-10-1020-10-1020-10-1020-10-1020-10-1020-10-1020-10-1020-10-1020-10-101004001020-10-1020-10-1020-10-1020-10-1
020-10-109005006090050070900500809005009020-10-1020-10-1020-10-1020-10-1020-10-1020-10-1020-10-1020-10-1020-10-1020-10-1020-10-1020-10-1020-10-1020-10-1020-10-1020-10-1020-10-1020-10-1020-10-1020-10-1020-10-1020-10-1020-10-1020-10-1020-10-1020-10-1020-10-1020-10-1020-10-1020-10-1020-10-1020-10-1020-10-1020-10-1020-10-1020-10-1020-10-1020-10-1020-10-1020-10-1020-10-1020-10-1020-10-1020-10-1020-10-1020-10-1020-10-1020-10-1020-10-1020-10-1020-10-1020-10-1020-10-101004001020-10-1020-10-1020-10-1020-10-1
020-10-109006006090060070900600809006009020-10-1020-10-1020-10-1020-10-1020-10-1020-10-1020-10-1020-10-1020-10-1020-10-1020-10-1020-10-1020-10-1020-10-1020-10-1020-10-1020-10-1020-10-1020-10-1020-10-1020-10-1020-10-1020-10-1020-10-1020-10-1020-10-1020-10-1020-10-1020-10-1020-10-1020-10-1020-10-1020-10-1020-10-1020-10-1020-10-1020-10-1020-10-1020-10-1020-10-1020-10-1020-10-1020-10-1020-10-1020-10-1020-10-1020-10-1020-10-1020-10-1020-10-1020-10-1020-10-1020-10-101004001020-10-1020-10-1020-10-1020-10-1
020-10-109005006090050070900500809005009020-10-1020-10-1020-10-1020-10-1020-10-1020-10-1020-10-1020-10-1020-10-1020-10-1020-10-1020-10-1020-10-1020-10-1020-10-1020-10-1020-10-1020-10-1020-10-1020-10-1020-10-1020-10-1020-10-1020-10-1020-10-1020-10-1020-10-1020-10-1020-10-1020-10-1020-10-1020-10-1020-10-1020-10-1020-10-104008033040080340400803504008036020-10-104008033040080340400803504008036020-10-104008033040080340400803504008036020-10-1020-10-1020-10-1020-10-101004001020-10-1020-10-1020-10-1020-10-1
020-10-109006006090060070900600809006009020-10-1020-10-1020-10-1020-10-1020-10-100021022000210230002102400021025020-10-100021022000210230002102400021025020-10-100021022000210230002102400021025020-10-100021022000210230002102400021025020-10-1020-10-1020-10-1020-10-1020-10-1020-10-1020-10-1020-10-1020-10-1020-10-1020-10-104009033040090340400903504009036020-10-104009033040090340400903504009036020-10-104009033040090340400903504009036020-10-1020-10-1020-10-1020-10-101004001020-10-1020-10-1020-10-1020-10-1
020-10-109005006090050070900500809005009020-10-1020-10-1020-10-1020-10-1020-10-100022022000220230002202400022025020-10-100022022000220230002202400022025000-10-100022022000220230002202400022025020-10-100022022000220230002202400022025020-10-1020-10-1020-10-1020-10-1020-10-1020-10-1020-10-1020-10-1020-10-1020-10-1020-10-104010033020-10-10401003504010036020-10-104010033020-10-10401003504010036020-10-104010033020-10-10401003504010036020-10-1020-10-1020-10-1020-10-101004001020-10-1020-10-1020-10-1020-10-1
020-10-109006006090060070900600809006009020-10-1020-10-1020-10-1020-10-1020-10-100023022020-10-10002302400023025020-10-100023022020-10-10002302400023025020-10-100023022020-10-10002302400023025020-10-100023022020-10-10002302400023025020-10-1020-10-1020-10-1020-10-1020-10-1020-10-1020-10-1020-10-1020-10-1020-10-1020-10-1020-10-1020-10-1020-10-1020-10-1020-10-1020-10-1020-10-1020-10-1020-10-1020-10-1020-10-1020-10-1020-10-1020-10-1020-10-1020-10-1020-10-1020-10-101004001020-10-1020-10-1020-10-1020-10-1
020-10-109005006090050070900500809005009020-10-1020-10-1020-10-1020-10-1020-10-1020-10-1020-10-1020-10-1020-10-1020-10-1020-10-1020-10-1020-10-1020-10-1020-10-1020-10-1020-10-1020-10-1020-10-1020-10-1020-10-1020-10-1020-10-1020-10-1020-10-1020-10-1020-10-1020-10-1020-10-1020-10-1020-10-1020-10-1020-10-1020-10-1020-10-1020-10-1020-10-1020-10-1020-10-1020-10-1020-10-1020-10-1020-10-1020-10-1020-10-1020-10-1020-10-1020-10-1020-10-1020-10-1020-10-1020-10-1020-10-101004001020-10-1020-10-1020-10-1020-10-1
020-10-109006006090060070900600809006009020-10-1020-10-1020-10-1020-10-1020-10-1020-10-1020-10-1020-10-1020-10-1020-10-1020-10-1020-10-1020-10-1020-10-1020-10-1020-10-1020-10-1020-10-1020-10-1020-10-1020-10-1020-10-1020-10-1020-10-1020-10-1020-10-1020-10-1020-10-1020-10-1020-10-1020-10-1020-10-1020-10-1020-10-1020-10-1020-10-1020-10-1020-10-1020-10-1020-10-1020-10-1020-10-1020-10-1020-10-1020-10-1020-10-1020-10-1020-10-1020-10-1020-10-1020-10-1020-10-1020-10-101004001020-10-1020-10-1020-10-1020-10-1
020-10-109005006090050070900500809005009020-10-1020-10-1020-10-1020-10-1020-10-1020-10-1020-10-1020-10-1020-10-1020-10-1020-10-1020-10-1020-10-1020-10-1020-10-1020-10-1020-10-1020-10-1020-10-1020-10-1020-10-1020-10-1020-10-1020-10-1020-10-1020-10-1020-10-1020-10-1020-10-1020-10-1020-10-1020-10-1020-10-1020-10-1020-10-1020-10-1020-10-1020-10-1020-10-1020-10-1020-10-1020-10-1020-10-1020-10-1020-10-1020-10-1020-10-1020-10-1020-10-1020-10-1020-10-1020-10-1020-10-101004001020-10-1020-10-1020-10-1020-10-1
020-10-109006006090060070900600809006009020-10-1020-10-1020-10-1020-10-1020-10-1020-10-1020-10-1020-10-1020-10-1020-10-1020-10-1020-10-1020-10-1020-10-1020-10-1020-10-1020-10-1020-10-1020-10-1020-10-1020-10-1020-10-1020-10-1020-10-1020-10-1020-10-1020-10-1020-10-1020-10-1020-10-1020-10-1020-10-1020-10-1020-10-1020-10-1020-10-1020-10-100047024000470250004702600047027020-10-100047024000470250004702600047027020-10-1020-10-1020-10-1020-10-1020-10-1020-10-1020-10-101004001020-10-101005001020-10-1020-10-1
020-10-109005006090050070900500809005009020-10-1020-10-1020-10-1020-10-1020-10-1020-10-1020-10-1020-10-1020-10-1020-10-1020-10-1020-10-1020-10-1020-10-1020-10-1020-10-1020-10-1020-10-1020-10-1020-10-1020-10-1020-10-1020-10-1020-10-1020-10-1020-10-1020-10-1020-10-1020-10-1020-10-1020-10-1020-10-1020-10-1020-10-1020-10-1020-10-1020-10-100048024000480250004802600048027020-10-100048024000480250004802600048027020-10-1020-10-1020-10-1020-10-1020-10-1020-10-1020-10-101004001020-10-1010050010100500201005002
020-10-109006006090060070900600809006009020-10-1020-10-1020-10-1020-10-1020-10-1020-10-1020-10-1040090470400904804009049020-10-104009051040090520405207304052074040520750405207604052077020-10-10004601000046011000460120004601300046014020-10-1020-10-1020-10-1020-10-1020-10-1020-10-1020-10-1020-10-1020-10-1020-10-1020-10-1020-10-1020-10-100049024000490250004902600049027020-10-100049024000490250004902600049027020-10-1020-10-1020-10-1020-10-1020-10-1020-10-1020-10-101004001020-10-1010060010100600201006002
020-10-109005006090050070900500809005009020-10-1020-10-1020-10-1020-10-1020-10-104010045040100460401004704010048040100490401005004010051040100520405307304053074040530750405307604053077020-10-10004701000047011000470120004701300047014020-10-1020-10-1020-10-1000-10-1000-10-1000-10-1020-10-1020-10-1020-10-1020-10-1020-10-1020-10-1020-10-100050024000500250005002600050027020-10-100050024000500250005002600050027020-10-1020-10-1020-10-1020-10-1020-10-1020-10-1020-10-101004001020-10-1020-10-1020-10-1020-10-1
020-10-109006006090060070900600809006009020-10-1020-10-1020-10-1020-10-1020-10-104011045040110460401104704011048040110490401105004011051040110520405407304054074020-10-10405407604054077020-10-10004801000048011000480120004801300048014020-10-1020-10-1020-10-1000-10-1000-10-1000-10-1020-10-1020-10-1020-10-1020-10-1020-10-1020-10-1020-10-1020-10-1020-10-1020-10-1020-10-1020-10-1020-10-1020-10-1020-10-1020-10-1020-10-1020-10-1020-10-1020-10-1020-10-1020-10-1020-10-101004001020-10-1020-10-1020-10-1020-10-1
0900500509005006090050070900500809005009020-10-1020-10-1020-10-1020-10-1020-10-10401204504012046020-10-10401204804012049040120500401205104012052020-10-104056074020-10-104056076020-10-1020-10-10004901000049011020-10-10004901300049014020-10-1020-10-1000-10-1000-10-1020-10-1020-10-1020-10-1020-10-1020-10-1020-10-1020-10-1020-10-1020-10-1020-10-1020-10-1020-10-1020-10-1020-10-1020-10-1020-10-1020-10-1020-10-1020-10-1020-10-1020-10-1020-10-1020-10-1020-10-1020-10-10100500101005002010050020100500201005002
0900600509006006090060070900600809006009020-10-1020-10-1020-10-1020-10-1020-10-1020-10-102028002020-10-1020-10-1020-10-102028002020-10-1020-10-1020-10-1020-10-1020-10-1020-10-1020-10-1020-10-102029002020-10-1020-10-1020-10-102029002020-10-1020-10-1020-10-1020-10-1020-10-1020-10-1020-10-1020-10-1020-10-1020-10-1020-10-1020-10-1020-10-1020-10-1020-10-1020-10-1020-10-1020-10-1020-10-1020-10-1020-10-1020-10-1020-10-1020-10-1020-10-1020-10-1020-10-1020-10-1020-10-101006001020-10-1020-10-1020-10-1020-10-1
020-10-1020-10-1020-10-1020-10-1020-10-1020-10-1020-10-1020-10-1020-10-1020-10-1020-10-1020-10-1020-10-1020-10-1020-10-1020-10-1020-10-1020-10-1020-10-1020-10-1020-10-1020-10-1020-10-1020-10-1020-10-1020-10-1020-10-1020-10-1020-10-1020-10-1020-10-1020-10-1020-10-1020-10-1020-10-1020-10-1020-10-1020-10-1020-10-1020-10-1020-10-1020-10-1020-10-1020-10-1020-10-1020-10-1020-10-1020-10-1020-10-1020-10-1020-10-1020-10-1020-10-1020-10-1020-10-1020-10-1020-10-1020-10-1020-10-1020-10-1020-10-1020-10-1020-10-1
020-10-1020-10-1020-10-1020-10-1020-10-1020-10-1020-10-1020-10-1020-10-1020-10-1020-10-1020-10-1020-10-1020-10-1020-10-1020-10-1020-10-1020-10-1020-10-1020-10-1020-10-1020-10-1020-10-1020-10-1020-10-1020-10-1020-10-1020-10-1020-10-1020-10-1020-10-1020-10-1040710890407109004071091040710920407109304071094020-10-1020-10-1020-10-1020-10-1020-10-1020-10-1020-10-1020-10-1020-10-1020-10-1020-10-1020-10-1020-10-1020-10-1020-10-1020-10-1020-10-1020-10-1020-10-1020-10-1020-10-1020-10-1020-10-1020-10-1020-10-1
020-10-1020-10-1020-10-1020-10-1020-10-1020-10-1020-10-1020-10-1020-10-1020-10-1020-10-1020-10-1020-10-1020-10-1020-10-1020-10-1020-10-1020-10-1020-10-1020-10-1020-10-1020-10-1020-10-1020-10-1020-10-1020-10-1020-10-1020-10-1020-10-1020-10-1020-10-1020-10-1040720890407209004072091040720920407209304072094020-10-1020-10-1020-10-1020-10-1020-10-1020-10-1020-10-1020-10-1020-10-1020-10-1020-10-1020-10-1020-10-1020-10-1020-10-1020-10-1020-10-1020-10-1020-10-1020-10-1020-10-1020-10-1020-10-1020-10-1020-10-1
020-10-1020-10-1020-10-1020-10-1020-10-1020-10-1020-10-1020-10-1020-10-1020-10-1020-10-1020-10-1020-10-1020-10-1020-10-1020-10-1020-10-1020-10-1020-10-1020-10-1020-10-1020-10-1020-10-1020-10-1020-10-1020-10-1020-10-1020-10-1020-10-1020-10-1020-10-104073088040730890407309004073091040730920407309304073094020-10-1020-10-1020-10-1020-10-1020-10-1020-10-1020-10-1020-10-1020-10-1020-10-1020-10-1020-10-1020-10-1020-10-1020-10-1020-10-1020-10-1020-10-1020-10-1020-10-1020-10-1020-10-1020-10-1020-10-1020-10-1
020-10-1020-10-1020-10-1020-10-1020-10-1020-10-1020-10-1020-10-1020-10-1020-10-1020-10-1020-10-1020-10-1020-10-1020-10-1020-10-1020-10-1020-10-1020-10-1020-10-1020-10-1020-10-1020-10-1020-10-1020-10-1020-10-1000200150002001600020017020-10-1020-10-104073088040740890407409004074091040740920407409304074094020-10-1020-10-1000090220000902300009024020-10-1020-10-1020-10-1020-10-1020-10-104010041020-10-1020-10-1020-10-1020-10-1020-10-1020-10-1020-10-1020-10-1020-10-10100200101002002010020020100200201002002
020-10-1020-10-1020-10-1020-10-1020-10-1020-10-1020-10-1020-10-1020-10-1020-10-1020-10-1020-10-1020-10-1020-10-1020-10-1020-10-1020-10-1020-10-1020-10-100008001020-10-1020-10-1020-10-100008005020-10-10002101400021015000210160002101700021018020-10-104075088040750890407509004075091040750920407509304075094020-10-10001002100010022000100230001002400010025020-10-1020-10-1020-10-1040110400401104104011042020-10-1020-10-1020-10-1020-10-1020-10-1020-10-1020-10-1020-10-10100300101003002010020010100201201002002
020-10-1020-10-1020-10-1020-10-1020-10-1020-10-1020-10-1020-10-1020-10-1020-10-1020-10-1000210020002100300021004020-10-1000210060002100700021008020-10-10000900100009002020-10-10000900400009005020-10-10002201400022015000220160002201700022018020-10-104076088040760890407609004076091040760920407609304076094020-10-10001102100011022000110230001102400011025020-10-1020-10-10401203904012040040120410401204204012043020-10-1020-10-1020-10-1020-10-1020-10-1020-10-1020-10-101004001020-10-10100201101002012020-10-1
020-10-1020-10-1020-10-1020-10-1020-10-1020-10-1020-10-1020-10-1020-10-1020-10-1020-10-1000220020002200300022004020-10-1000220060002200700022008020-10-10001000100010002020-10-10001000400010005020-10-100023014020-10-1000230160002301700023018020-10-1040770880407708904077090020-10-1040770920407709304077094020-10-100012021020-10-1000120230001202400012025020-10-1020-10-104013039020-10-1040130410401304204013043020-10-1020-10-1020-10-1020-10-1020-10-1020-10-1020-10-101004001020-10-101004001020-10-1020-10-1
020-10-1020-10-1020-10-1020-10-1020-10-1020-10-1020-10-1020-10-1020-10-1020-10-1020-10-1020-10-1020-10-102029000020-10-102029000020-10-1020-10-1020-10-1020-10-1020-10-1020-10-1020-10-1020-10-1020-10-1020-10-1020-10-1020-10-1020-10-102027000020-10-1020-10-1020-10-1020-10-1020-10-1020-10-1020-10-1020-10-1020-10-102028002020-10-1020-10-1020-10-1020-10-1020-10-1020-10-1020-10-1020-10-1020-10-1020-10-102027000020-10-1020-10-1020-10-1020-10-1020-10-1020-10-1020-10-101004001020-10-101004001020-10-1020-10-1
020-10-1020-10-1020-10-1020-10-1020-10-1020-10-1020-10-1020-10-1020-10-1020-10-1020-10-1020-10-1020-10-1020-10-1020-10-1020-10-1020-10-1020-10-1020-10-1020-10-1020-10-1020-10-1020-10-1020-10-1020-10-1020-10-1020-10-1020-10-1020-10-1020-10-1020-10-1020-10-1020-10-1020-10-1020-10-1020-10-1020-10-1020-10-1020-10-1020-10-1020-10-1020-10-1020-10-1020-10-1020-10-1020-10-1020-10-1020-10-1020-10-1020-10-1020-10-1020-10-1020-10-1020-10-1020-10-1020-10-1020-10-1020-10-101004001020-10-101004001020-10-1020-10-1
020-10-1020-10-1020-10-1020-10-1020-10-1020-10-1020-10-1020-10-1020-10-1020-10-1020-10-1020-10-1020-10-1020-10-1020-10-1020-10-1020-10-1020-10-1020-10-1020-10-1020-10-1020-10-1020-10-1020-10-1020-10-1020-10-1020-10-1020-10-1020-10-1020-10-1020-10-1020-10-1020-10-1020-10-1020-10-1020-10-1020-10-1020-10-1020-10-1020-10-1020-10-1020-10-1020-10-1020-10-1020-10-1020-10-1020-10-1020-10-1020-10-1020-10-1020-10-1020-10-1020-10-1020-10-1020-10-1020-10-1020-10-1020-10-101004001020-10-101004001020-10-1020-10-1
0900500609005007020-10-1020-10-1020-10-1020-10-1020-10-1020-10-1020-10-1020-10-1020-10-1020-10-1020-10-1020-10-1020-10-1020-10-1020-10-1020-10-1020-10-1020-10-1020-10-1020-10-1020-10-1020-10-1020-10-1020-10-1020-10-1020-10-1020-10-1020-10-1020-10-1020-10-1020-10-1020-10-1020-10-1020-10-1020-10-1020-10-1020-10-1020-10-1020-10-1020-10-1020-10-1020-10-1020-10-1020-10-1020-10-1020-10-1020-10-1020-10-1020-10-1020-10-1020-10-1020-10-1020-10-1020-10-1020-10-1020-10-101004001020-10-101004001020-10-1020-10-1
0900600609006007020-10-1020-10-1020-10-1020-10-1020-10-1020-10-1020-10-1020-10-1020-10-1020-10-1020-10-1020-10-1020-10-1020-10-1020-10-1020-10-1020-10-1020-10-1020-10-1020-10-1020-10-1020-10-1020-10-1020-10-1020-10-1020-10-1020-10-1020-10-1020-10-1020-10-1020-10-1020-10-1020-10-1020-10-1020-10-1020-10-1020-10-1020-10-1020-10-1020-10-1020-10-1020-10-1020-10-1020-10-1020-10-1020-10-1020-10-1020-10-1020-10-1020-10-1020-10-1020-10-1020-10-1020-10-1020-10-1020-10-101004001020-10-101004001020-10-1020-10-1
0900500609005007020-10-1020-10-1020-10-1020-10-1020-10-1020-10-1020-10-1020-10-1020-10-1020-10-1020-10-1020-10-1020-10-1020-10-1020-10-1020-10-1020-10-1020-10-1020-10-1020-10-1020-10-1020-10-1020-10-1020-10-1020-10-1020-10-1020-10-1020-10-1020-10-1020-10-1020-10-1020-10-1020-10-1020-10-1020-10-1020-10-1020-10-1020-10-1020-10-1020-10-1020-10-1020-10-1020-10-1020-10-1020-10-1020-10-1020-10-1020-10-1020-10-1020-10-1020-10-1020-10-1020-10-1020-10-1020-10-1020-10-101004001020-10-101004001020-10-1020-10-1
0900600609006007020-10-1020-10-1020-10-1020-10-1020-10-1020-10-1020-10-1020-10-100008014000080150000801600008017020-10-100008014000080150000801600008017020-10-100008014000080150000801600008017020-10-100008014000080150000801600008017020-10-1020-10-1020-10-1020-10-1020-10-1020-10-1020-10-1020-10-1020-10-1020-10-1020-10-100021022000210230002102400021025020-10-100021022000210230002102400021025020-10-100021022000210230002102400021025020-10-1020-10-1020-10-1020-10-101004001020-10-101004001020-10-1020-10-1
0900500609005007020-10-1020-10-1020-10-1020-10-1020-10-1020-10-1020-10-1020-10-100009014000090150000901600009017020-10-100009014000090150000901600009017020-10-100009014000090150000901600009017020-10-100009014000090150000901600009017020-10-1020-10-1020-10-1020-10-1020-10-1020-10-1020-10-1020-10-1020-10-1020-10-1020-10-100022022000220230002202400022025020-10-100022022000220230002202400022025020-10-100022022000220230002202400022025020-10-1020-10-1020-10-1020-10-101004001020-10-101004001020-10-1020-10-1
0900600609006007020-10-1020-10-1020-10-1020-10-1020-10-1020-10-1020-10-1020-10-100010014020-10-10001001600010017020-10-100010014020-10-10001001600010017020-10-100010014020-10-10001001600010017020-10-100010014020-10-10001001600010017020-10-1020-10-1020-10-1020-10-1020-10-1020-10-1020-10-1020-10-1020-10-1020-10-1020-10-100023022020-10-10002302400023025020-10-100023022020-10-10002302400023025020-10-100023022020-10-10002302400023025020-10-1020-10-1020-10-1020-10-101004001020-10-101004001020-10-1020-10-1
0900500609005007020-10-1020-10-1020-10-1020-10-1020-10-1020-10-1020-10-1020-10-1020-10-1020-10-1020-10-1020-10-1020-10-1020-10-1020-10-1020-10-1020-10-1020-10-1020-10-1020-10-1020-10-1020-10-1020-10-1020-10-1020-10-1020-10-1020-10-1020-10-1020-10-1020-10-1020-10-1020-10-1020-10-1020-10-1020-10-1020-10-1020-10-1020-10-1020-10-1020-10-1020-10-1020-10-1020-10-1020-10-1020-10-1020-10-1020-10-1020-10-1020-10-1020-10-1020-10-102027000020-10-1020-10-1020-10-1020-10-101004001020-10-101004001020-10-1020-10-1
0900600609006007020-10-1020-10-1020-10-1020-10-1020-10-1020-10-1020-10-1020-10-1020-10-1020-10-1020-10-1020-10-1020-10-1020-10-1020-10-1020-10-1020-10-1020-10-1020-10-1020-10-1020-10-1020-10-1020-10-1020-10-1020-10-1020-10-1020-10-1020-10-1020-10-1020-10-1020-10-1020-10-1020-10-1020-10-1020-10-1020-10-1020-10-1020-10-1020-10-1020-10-1020-10-1020-10-1020-10-1020-10-1020-10-1020-10-1020-10-1020-10-1020-10-1020-10-1020-10-1020-10-1020-10-1020-10-1020-10-1020-10-101004001020-10-101004001020-10-1020-10-1
0900500609005007020-10-1020-10-1020-10-1020-10-1020-10-1020-10-1020-10-1020-10-1020-10-1020-10-1020-10-1020-10-1020-10-1020-10-1020-10-1020-10-1020-10-1020-10-1020-10-1020-10-1020-10-1020-10-1020-10-1020-10-1020-10-1020-10-1020-10-1020-10-1020-10-1020-10-1020-10-1020-10-1020-10-1020-10-1020-10-1020-10-1020-10-1020-10-1020-10-1020-10-1020-10-1020-10-1020-10-1020-10-1020-10-1020-10-1020-10-1020-10-1020-10-1020-10-1020-10-1020-10-1020-10-1020-10-1020-10-1020-10-101004001020-10-1010040010100201501002016
0900600609006007020-10-1020-10-1020-10-1020-10-1020-10-1020-10-1020-10-1020-10-1020-10-1020-10-1020-10-1020-10-1020-10-1020-10-1020-10-1020-10-1020-10-1020-10-1020-10-1020-10-1020-10-1020-10-1020-10-1020-10-1020-10-1020-10-1020-10-1020-10-1020-10-1020-10-1020-10-1020-10-1020-10-1020-10-1020-10-1020-10-1020-10-1020-10-1020-10-1020-10-1020-10-1020-10-1020-10-1020-10-1020-10-1020-10-1020-10-1020-10-1020-10-1020-10-1020-10-1020-10-1020-10-1020-10-1020-10-1020-10-101004001020-10-1010040010100301501004008
0900500609005007020-10-1020-10-1020-10-1020-10-1020-10-1020-10-1020-10-1020-10-1020-10-1020-10-1020-10-1020-10-1020-10-1020-10-1020-10-1020-10-1020-10-1020-10-1020-10-1020-10-1020-10-1020-10-1020-10-1020-10-1020-10-1020-10-1020-10-1020-10-1020-10-1020-10-1020-10-1020-10-1020-10-1020-10-1020-10-1020-10-1020-10-1020-10-1020-10-1020-10-1020-10-1020-10-1020-10-1020-10-1020-10-1020-10-1020-10-1020-10-1020-10-1020-10-1020-10-1020-10-1020-10-1020-10-1020-10-1020-10-101004001020-10-1010040010100400101003002
0900600609006007020-10-1020-10-1020-10-1020-10-1020-10-1020-10-1020-10-1020-10-1020-10-1020-10-1020-10-1020-10-1020-10-1020-10-1020-10-1020-10-1020-10-1020-10-1020-10-1020-10-1020-10-1020-10-1020-10-1020-10-1020-10-1020-10-1020-10-1020-10-1020-10-1020-10-1020-10-1020-10-1020-10-1020-10-1020-10-1020-10-1020-10-1020-10-1020-10-1020-10-1020-10-1020-10-1020-10-1020-10-1020-10-1020-10-1020-10-1020-10-1020-10-1020-10-1020-10-1020-10-1020-10-1020-10-1020-10-1020-10-101004001020-10-1010040010100400101003002
0900500609005007020-10-1020-10-1020-10-1020-10-1020-10-1020-10-1020-10-1020-10-1020-10-1020-10-1020-10-1020-10-1020-10-1020-10-1020-10-1020-10-1020-10-1020-10-1020-10-1020-10-1020-10-1020-10-1020-10-1020-10-1020-10-1020-10-1020-10-1020-10-1020-10-1020-10-1020-10-1020-10-1020-10-1020-10-1020-10-1020-10-1020-10-1020-10-1020-10-1020-10-1020-10-1020-10-1020-10-1020-10-1020-10-1020-10-1020-10-1020-10-1020-10-1020-10-1020-10-1020-10-1020-10-1020-10-1020-10-1020-10-101004001020-10-1010040010100400101003002
0900600609006007020-10-1020-10-1020-10-1020-10-1020-10-1020-10-1020-10-1020-10-1020-10-1020-10-1020-10-1020-10-1020-10-1020-10-1020-10-1020-10-1020-10-1020-10-1020-10-1020-10-1020-10-1020-10-1020-10-1020-10-1020-10-1020-10-1020-10-1020-10-1020-10-1020-10-1020-10-1020-10-1020-10-1020-10-1020-10-1020-10-1020-10-1020-10-1020-10-1020-10-1020-10-1020-10-1020-10-1020-10-1020-10-1020-10-1020-10-1020-10-1020-10-1020-10-1020-10-1020-10-1020-10-1020-10-1020-10-1020-10-101004001020-10-1010040010100400101003002
090050060900500709005006090050070900500609005007090050060900500709005006090050070900500609005007090050060900500709005006090050070900500609005007090050060900500709005006090050070900500609005007090050060900500709005006090050070900500609005007020-10-1020-10-1020-10-1020-10-1020-10-1020-10-1020-10-1020-10-1020-10-1020-10-109005006090050070900500609005007090050060900500709005006090050070900500609005007090050060900500709005006090050070900500609005007020-10-1020-10-101004001020-10-1010040010100400101003002
090060060900600709006006090060070900600609006007090060060900600709006006090060070900600609006007090060060900600709006006090060070900600609006007090060060900600709006006090060070900600609006007090060060900600709006006090060070900600609006007020-10-1020-10-1020-10-1020-10-1020-10-1020-10-1020-10-1020-10-1020-10-1020-10-1020-10-1020-10-1020-10-109006007090060060900600709006006090060070900600609006007090060060900600709006006090060070900600609006007020-10-1020-10-101004001020-10-1010040010100400101003002
