40
40
0111111111111111111111111111100000000000
0111111111111111111111111111100000000000
0111111111111111111111111111100000000000
0111111111111111111111111111100000000000
0111111111111111111111111111111000000000
0111111111111111111111111111111000000000
0110000000000000000000000000000000000000
0110000000000000000000000000000000000000
0110000000000000000000000000000000000000
0110000000000000000000000000000000000000
0110000000000000000000000000000000000000
0110000000000000000000000000000000000000
0110000000000000000000000000000000000000
0110000000000000000000000000000000000000
0110000000000010000000000000000000000000
0110000000000000000000000000000000000000
0110000000000000000000000000000000000000
0110000000000000000000000000000000000000
0110000000000000000000000000000000000000
0110000000000000000000000000000000000000
0110000000000000000000000000000000000000
0110000000000000000000000000000000000000
1111100000000000000000000000000000000000
1111100000000000000000000000000000000000
0000000000000000000000000000000000000000
0000000000000000000000000000000000000000
0000000000000000000000000000000000000000
0000000000000000000000000000000000000000
0000000000000000000000000000000000000000
0000000000000000000000000000000000000000
0000000000000000000000000000000000000000
0000000000000000000000000000000000000000
0000000000000000000000000000000000000000
0000000000000000000000000000000000000000
0000000000000000000000000000000000000000
0000000000000000000000000000000000000000
0000000000000000000000000000000000000000
0000000000000000000000000000000000000000
0000000000000000000000000000000000000000
0000000000000000000000000000000000000000
