40
40
023110023110023110023110023110023110023110023110023110023110023110023110023110023110023110023110023110023110023110030104074210074115074114074114074113071415023110023110023110023110023110023110023110023110023110023110023110023110023110023110
023110023110023110023110023110023110023110023110023110023110023110023110023110023110023110023110023110023110023110030104074110074114074114074114074213071415023110023110023110023110023110023110023110023110023110023110023110023110023110023110
023110023110023110023110023110023110023110023110023110023110023110023110023110023110023110023110023110023110023110030104074210074115074114074115074113071415023110023110023110023110023110023110023110023110023110023110023110023110023110023110
023110023110023110023110023110023110023110023110023110023110023110023110023110023110023110023110023110023110023110030104074110074114074114074114074213071315023110023110023110023110023110023110023110023110023110023110023110023110023110023110
023110023110023110023110023110023110023110023110023110023110023110023110023110023110023110023110023110023110023110030104074210074114074115074114074113071415023110023110023110023110023110023110023110023110023110023110023110023110023110023110
023110023110023110023110023110023110023110023110023110023110023110023110023110023110023110023110023110023110023110030104074110074114074114074114074213071415023110023110023110023110073419073420023110023110023110023110023110023110023110023110
023110023110023110023110023110023110023110030002030003030003030003030003030003030003030003030003030003030003030003030204074210074014074014074014074113071614071615071415071415071615073519073520071415071614071415071415071615071415071415071415
023110023110023110023110023110023110023110030104071315071414071315071615071414071414005658005659005660005661005662031102074110074014074115074014074113071414071615071414071414071615073619073620071315071414071414071315071414071615071414071615
023110023110023110023110023110023110023110030104071315071315071514041493041493071415005758005759005760005761005762031202074210074014074014074014074113071315071415071315071315071315071315071415071415071315071315071514071315071415071315071315
023110023110023110023110023110023110023110030104071315041503041503041503041503041503005858005859005860005861005862074012074212074014074014074014074211074011074011074011074011044267044267044268044269044270044271074011074013073419073420073419
023110023110023110023110023110023110023110030104071315041513041513041513041513041513005958005959005960005961005962074014074014074014074115074014074014074014074014044364044365044366044367044368044369044370044371044372074213073419073420073419
023110023110023110023110023110023110023110030104071315041523041523041523041523041523006058006059006060006061006062074015074015074115074115074015074115074115074015044464044465044466044467044468044469044470044471044472074213073419073420073419
023110023110023110023110023110023110023110030104071414041533041533041543041543041533006158006159006160006161006162074015074115074115074115074115074115074115074115044564044565044566044567044568044569044570044571044572074213073419073420073419
023110023110023110023110023110023110023110030104071315074110041553041553041553041553006258006259006260006261006262074015074115074115074115074115074115074115074115044664044665044666074115074115074115074115074115074115074213073419073420073419
023110023110023110023110023110023110023110030104071315074210041563041563041563041563006358006359074115006361006362074015074115074115074115074115074115074115074115074114044765044766044767044768044769044770044771074114074213073419073420073419
023110023110023110023110023110023110023110030104071514074110074015074115074015074015074015074015074115074115074015074115074115074115074115074115074115074114074114074114044865044866044867044868044869044870044871074114074213073419073420073419
023110023110023110023110023110023110023110030104071315074110074015074015074115074015074114074115074015074015074114074114074115074115074115074115074115074115074114074114074114074114074115074114074114074114074114074114074213073419073420073419
023110023110023110023110023110023110023110031105031106031107074114074114074114074114074115074114074114074115074114074114074114074115000160000161000162074115074114000165000166000167074114074114000170000171000172074114074213073419073420073419
030000030000030000030000030000030000030000030204031206031206074114074114074115074115074115074114074115074114074114074115074114000259000260000261000262000263000264000265000266000267000268000269000270000271000272000273074213073519073520073519
074012074011074012074012074012074011074012074012074011074212074115074115074114074114074114074115074114074114074114074114074115000359000360000361000362000363000364000365000366000367000368000369000370000371000372000373031105031106031107073619
074115074015074115074114074114074015074114074015074115074115074114074114074114074115074114000408000409000410000411074114074115000459000460000461000462000463000464000465000466000467000468000469000470000471000472000473074211031206074012074012
074114074114074114074015074114074114074115074115074114074115074114074115074114074114074115000508000509000510000511074114074114000559000560000561000562000563000564000565000566000567000568000569000570000571000572000573074015074015074015074015
074114074115074114074114074114074114074114074114074015074115074114074115074115074115074115000808000809000810000811074115074115000659000660000661000662000663000664000665000666000667000668000669000670000671000672000673074015074015074015074015
074015074015074114074015074015074115074015074015074114074114074114074015074015074015030904000908000909000910000911074015074015000759000760000761000762000763000764000765000766000767000768000769000770000771000772000773074015074015074015074015
074311074311074311074311074311074311074311074311074311074311074112074015074015074015074111074312074312074312074312074312074112000859000860000861000862000863000864000865000866000867000868000869000870000871000872000873074111074311072724072725
022501022502022501022502022501022502022501022502022501022502074210074015074015074015074213020000020000020000020000020000074110000959000960000961000962000963000964000965000966000967000968000969000970000971000972000973074113072823072824072825
022601022602022601022602022601022602022601022602022601022602074110074015074015074015074213020000020000020000020000020000074110001059001060001061001062001063001064001065001066001067001068001069001070001071001072001073074113072823072824072825
072220072221072222020000020000020000020000073723073724031105031106031107074015074015074213020000020000020000020000020000074110001159001163001163001163001163001164001165001166001167001168001169001170001171001172001173074113072923072924072925
072320072321072322072820072821020000020000073823073824020000031206074311074311074311074313020000020000020000020000020000074110001359001360001361001362001363001364001365001366001367001368001369001370001370001372001373074113072823072824072825
072420072421072919072920072921072922020000020000020707020000020000020000020000020000020000020000020000020000020000020000074110001459001460001461001462001463001464001465001466001467001468001469001470001471001472001473074113072923072924072925
072620072621020000073220073221020000020000020000020707020000020000020000020000020000020000020000020000020000020000020000074110001559001560001561001562001563031104001565001566001567001568001569002155002156002157001573074213072823072824072825
020000020000020000020000020000020000020000020000020707020000020000020000020000020000020000020000020000020000020000020000074210074015074015074015074015074015031204074015074015074015074015074015002255002256002257074015074213072923072924072925
073723073724073723073724073723073724073723073724020707020000021918021920021920021920021921020000020707020000020000020000074310074311074311074311074311074311074311074311074311074311074311074311002355002356002357074311074313072823072824072825
073823073824073823073824073823073824073823073824020707020000022018022020022020022020022021020000020707020000020000020000020000020000020000020000020000020000020000021209021211021211021211021212020000020000020000020000020000072923072924072925
073723073724073723073724073723073724073723073724020707020000022018022020022020022020022021020000020707021601021602021601021602021601021602021601021602021601021602021309021311021311021311021312020000020000020000020000020000072823072824072825
073823073824073823073824073823073824073823073824020707020000022018022020022020022020022021020000020707021701021702021701021702021701021702021702021702021701021702021309021311021311021311021312072823072724072725020000072724072923072924072925
073723073724073723073724073723073724073723073724020707020000022018022020022020022020022021020000020707021601021602021601021602021601021602021601021602021601021602021309021311021311021311021312072823072824072825072823072824072823072824072825
073823073824073823073824073823073824073823073824020707020000022018022020022020022020022021020000020707021701021702021702021702021701021702021701021702021701021702021309021311021311021311021312072923072924072925072923072924072923072924072925
073723073724073723073724073723073724073723073724020707020000022018022020022020022020022021020000020707021601021602021601021602021601021602021601021602021601021602021309021311021311021311021312072823072824072825072823072824072823072824072825
073823073824073823073824073823073824073823073824020807020000022018022020022020022020022021020000020807021701021702021701021702021701021702021701021702021701021702021309021311021311021311021312072923072924072925072923072924072923072924072925
