80
40
09020509020609020709020609020709020609020709020809020709020809020709020809020709020809020709020809020709020809020709020809020709020809020709020809020709020809020709020809020709020802-1-102-1-102-1-102-1-102-1-102-1-102-1-102-1-102-1-102-1-109020509020609020709020809020709020809020709020809020709020809020709020809020709020809020709020809020709020809020902-1-102-1-102-1-102-1-102-1-102-1-102-1-102-1-102-1-102-1-102-1-102-1-102-1-102-1-102-1-102-1-102-1-102-1-102-1-102-1-102-1-1
09030509030609030709030609030709030609030709030809030709030809030709030809030709030809030709030809030709030809030709030809030709030809030709030809030709030809030709030809030709030809010902-1-102-1-102-1-102-1-102-1-102-1-102-1-102-1-102-1-109030509010609030709030809030709030809030709030809030709030809030709030809030709030809030709030809030709030809030902-1-102-1-102-1-102-1-102-1-102-1-102-1-102-1-102-1-102-1-102-1-102-1-102-1-102-1-102-1-102-1-102-1-102-1-102-1-102-1-102-1-1
09020709020609020709020609020709020609020709020609020709020609020709020609020709020609020709020609020709020609020709020609020709020609020709020609020709020609020709020609020709020809020902-1-102-1-102-1-102-1-102-1-102-1-102-1-102-1-102-1-109020509020609020709020609020709020609020709020609020709020609020709020609020709020609020709020609020709020809020902-1-102-1-102-1-102-1-102-1-102-1-102-1-102-1-102-1-102-1-102-1-102-1-102-1-102-1-102-1-102-1-102-1-102-1-102-1-102-1-102-1-1
09010709010809010709030809030709030809030709030609030709030609030709030609030709030609030709030609030709030609030709030609030709030609030709030609030709030609030709030609030709030809030902-1-102-1-102-1-102-1-102-1-102-1-102-1-102-1-102-1-109030509030609030709030609030709030609030709030609030709030609030709030609030709030609030709030609030709030809030902-1-102-1-102-1-102-1-102-1-102-1-102-1-102-1-102-1-102-1-102-1-102-1-102-1-102-1-102-1-102-1-102-1-102-1-102-1-102-1-102-1-1
09020709020809020709020809040709040809040709040609040709040609040709040609040709040609040709040609040709040609040709040609040709040609040709040609040709040609040709040609040709040809040902-1-102-1-102-1-102-1-102-1-102-1-102-1-102-1-102-1-109040509040609040709040609040709040609040709040609040709040609040709040609040709040609040709040609040709040809040902-1-102-1-102-1-102-1-102-1-102-1-102-1-102-1-102-1-102-1-102-1-102-1-102-1-102-1-102-1-102-1-102-1-102-1-102-1-102-1-102-1-1
09010709010809010709030809030902-1-102-1-102-1-102-1-102-1-102-1-102-1-102-1-102-1-102-1-102-1-102-1-102-1-102-1-102-1-102-1-102-1-102-1-102-1-102-1-102-1-102-1-102-1-102-1-102-1-102-1-102-1-102-1-102-1-102-1-102-1-102-1-102-1-102-1-102-1-102-1-102-1-102-1-102-1-102-1-102-1-102-1-102-1-102-1-102-1-102-1-102-1-102-1-102-1-102-1-102-1-102-1-102-1-102-1-102-1-102-1-102-1-102-1-102-1-102-1-102-1-102-1-102-1-102-1-102-1-102-1-102-1-102-1-102-1-102-1-102-1-102-1-102-1-102-1-102-1-1
09020709020809020709020809020902-1-102-1-102-1-102-1-102-1-102-1-102-1-102-1-102-1-102-1-102-1-102-1-102-1-102-1-102-1-102-1-102-1-102-1-102-1-102-1-102-1-102-1-102-1-102-1-102-1-102-1-102-1-102-1-102-1-102-1-102-1-102-1-102-1-102-1-102-1-102-1-102-1-102-1-102-1-102-1-102-1-102-1-102-1-102-1-102-1-102-1-102-1-102-1-102-1-102-1-102-1-102-1-102-1-102-1-102-1-102-1-102-1-102-1-102-1-102-1-102-1-102-1-102-1-102-1-102-1-102-1-102-1-102-1-102-1-102-1-102-1-102-1-102-1-102-1-102-1-1
09010709010809010709010809010902-1-102-1-102-1-102-1-102-1-102-1-102-1-102-1-102-1-102-1-102-1-102-1-102-1-102-1-102-1-102-1-102-1-102-1-102-1-102-1-102-1-102-1-102-1-102-1-102-1-102-1-102-1-102-1-102-1-102-1-102-1-102-1-102-1-102-1-102-1-102-1-102-1-102-1-102-1-102-1-102-1-102-1-102-1-102-1-102-1-102-1-102-1-102-1-102-1-102-1-102-1-102-1-102-1-102-1-102-1-102-1-102-1-102-1-102-1-102-1-102-1-102-1-102-1-102-1-102-1-102-1-102-1-102-1-102-1-102-1-102-1-102-1-102-1-102-1-102-1-1
09020709020809020709020809020902-1-102-1-102-1-102-1-102-1-102-1-102-1-102-1-102-1-102-1-102-1-102-1-102-1-102-1-102-1-102-1-102-1-102-1-102-1-102-1-102-1-102-1-102-1-102-1-102-1-102-1-102-1-102-1-102-1-102-1-102-1-102-1-102-1-102-1-102-1-102-1-102-1-102-1-102-1-102-1-102-1-102-1-102-1-102-1-102-1-102-1-102-1-102-1-102-1-102-1-102-1-102-1-102-1-102-1-102-1-102-1-102-1-102-1-102-1-102-1-102-1-102-1-102-1-102-1-102-1-102-1-102-1-102-1-102-1-102-1-102-1-102-1-102-1-102-1-102-1-1
09010709010809010709010809010902-1-102-1-102-1-102-1-102-1-102-1-102-1-102-1-102-1-102-1-102-1-102-1-102-1-102-1-102-1-102-1-102-1-102-1-102-1-102-1-102-1-102-1-102-1-102-1-102-1-102-1-102-1-102-1-102-1-102-1-102-1-102-1-102-1-102-1-102-1-102-1-102-1-102-1-102-1-102-1-102-1-102-1-102-1-102-1-102-1-102-1-102-1-102-1-102-1-102-1-102-1-102-1-102-1-102-1-102-1-102-1-102-1-102-1-102-1-102-1-102-1-102-1-102-1-102-1-102-1-102-1-102-1-102-1-102-1-102-1-102-1-102-1-102-1-102-1-102-1-1
09020709020809020709020809020902-1-102-1-102-1-102-1-102-1-102-1-102-1-102-1-102-1-102-1-102-1-102-1-102-1-102-1-102-1-102-1-102-1-102-1-102-1-102-1-102-1-102-1-102-1-102-1-102-1-102-1-102-1-102-1-102-1-102-1-102-1-102-1-102-1-102-1-102-1-102-1-102-1-102-1-102-1-102-1-102-1-102-1-102-1-102-1-102-1-102-1-102-1-102-1-102-1-102-1-102-1-102-1-102-1-102-1-102-1-102-1-102-1-102-1-102-1-102-1-102-1-102-1-102-1-102-1-102-1-102-1-102-1-102-1-102-1-102-1-102-1-102-1-102-1-102-1-102-1-1
09010709010809010709010809010902-1-102-1-102-1-102-1-102-1-102-1-102-1-102-1-102-1-102-1-102-1-102-1-102-1-102-1-102-1-102-1-102-1-102-1-102-1-102-1-102-1-102-1-102-1-102-1-102-1-102-1-102-1-102-1-102-1-102-1-102-1-102-1-102-1-102-1-102-1-102-1-102-1-102-1-102-1-102-1-102-1-102-1-102-1-102-1-102-1-102-1-102-1-102-1-102-1-102-1-102-1-102-1-102-1-102-1-102-1-102-1-102-1-102-1-102-1-102-1-102-1-102-1-102-1-102-1-102-1-102-1-102-1-102-1-102-1-102-1-102-1-102-1-102-1-102-1-102-1-1
09020709020609020709020809020902-1-102-1-102-1-102-1-102-1-102-1-102-1-102-1-102-1-102-1-102-1-102-1-102-1-102-1-102-1-102-1-102-1-102-1-102-1-102-1-102-1-102-1-102-1-102-1-102-1-102-1-102-1-102-1-102-1-102-1-102-1-102-1-102-1-102-1-102-1-102-1-102-1-102-1-102-1-102-1-102-1-102-1-102-1-102-1-102-1-102-1-102-1-102-1-102-1-102-1-102-1-102-1-102-1-102-1-102-1-102-1-102-1-102-1-102-1-102-1-102-1-102-1-102-1-102-1-102-1-102-1-102-1-102-1-102-1-102-1-102-1-102-1-102-1-102-1-102-1-1
09010709030609030709010809010902-1-102-1-102-1-102-1-102-1-102-1-102-1-102-1-102-1-102-1-102-1-102-1-102-1-102-1-102-1-102-1-102-1-102-1-102-1-102-1-102-1-102-1-102-1-102-1-102-1-102-1-102-1-102-1-102-1-102-1-102-1-102-1-102-1-102-1-102-1-102-1-102-1-102-1-102-1-102-1-102-1-102-1-102-1-102-1-102-1-102-1-102-1-102-1-102-1-102-1-102-1-102-1-102-1-102-1-102-1-102-1-102-1-102-1-102-1-102-1-102-1-102-1-102-1-102-1-102-1-102-1-102-1-102-1-102-1-102-1-102-1-102-1-102-1-102-1-102-1-1
09020709020609020709020809020902-1-102-1-102-1-102-1-102-1-102-1-102-1-102-1-102-1-102-1-102-1-102-1-102-1-102-1-102-1-102-1-102-1-102-1-102-1-102-1-102-1-102-1-102-1-102-1-102-1-102-1-102-1-102-1-102-1-102-1-102-1-102-1-102-1-102-1-102-1-102-1-102-1-102-1-102-1-102-1-102-1-102-1-102-1-102-1-102-1-102-1-102-1-102-1-102-1-102-1-102-1-102-1-102-1-102-1-102-1-102-1-102-1-102-1-102-1-102-1-102-1-102-1-102-1-102-1-102-1-102-1-102-1-102-1-102-1-102-1-102-1-102-1-102-1-102-1-102-1-1
09010709030609030709010809010902-1-102-1-102-1-102-1-102-1-102-1-102-1-102-1-102-1-102-1-102-1-102-1-102-1-102-1-102-1-102-1-102-1-102-1-102-1-102-1-102-1-102-1-102-1-102-1-102-1-102-1-102-1-102-1-102-1-102-1-102-1-102-1-102-1-102-1-102-1-102-1-102-1-102-1-102-1-102-1-102-1-102-1-102-1-102-1-102-1-102-1-102-1-102-1-102-1-102-1-102-1-102-1-102-1-102-1-102-1-102-1-102-1-102-1-102-1-102-1-102-1-102-1-102-1-102-1-102-1-102-1-102-1-102-1-102-1-102-1-102-1-102-1-102-1-102-1-102-1-1
09020709020609020709020809020902-1-102-1-102-1-102-1-102-1-102-1-102-1-102-1-102-1-102-1-102-1-102-1-102-1-102-1-102-1-102-1-102-1-102-1-102-1-102-1-102-1-102-1-102-1-102-1-102-1-102-1-102-1-102-1-102-1-102-1-102-1-102-1-102-1-102-1-102-1-102-1-102-1-102-1-102-1-102-1-102-1-102-1-102-1-102-1-102-1-102-1-102-1-102-1-102-1-102-1-102-1-102-1-102-1-102-1-102-1-102-1-102-1-102-1-102-1-102-1-102-1-102-1-102-1-102-1-102-1-102-1-102-1-102-1-102-1-102-1-102-1-102-1-102-1-102-1-102-1-1
09010709030609030709010809010902-1-102-1-102-1-102-1-102-1-102-1-102-1-102-1-102-1-102-1-102-1-102-1-102-1-102-1-102-1-102-1-102-1-102-1-102-1-102-1-102-1-102-1-102-1-102-1-102-1-102-1-102-1-102-1-102-1-102-1-102-1-102-1-102-1-102-1-102-1-102-1-102-1-102-1-102-1-102-1-102-1-102-1-102-1-102-1-102-1-102-1-102-1-102-1-102-1-102-1-102-1-102-1-102-1-102-1-102-1-102-1-102-1-102-1-102-1-102-1-102-1-102-1-102-1-102-1-102-1-102-1-102-1-102-1-102-1-102-1-102-1-102-1-102-1-102-1-102-1-1
09020709020609020709020809020902-1-102-1-102-1-102-1-102-1-102-1-102-1-102-1-102-1-102-1-102-1-102-1-102-1-102-1-102-1-102-1-102-1-102-1-102-1-102-1-102-1-102-1-102-1-102-1-102-1-102-1-102-1-102-1-102-1-102-1-102-1-102-1-102-1-102-1-102-1-102-1-102-1-102-1-102-1-102-1-102-1-102-1-102-1-102-1-102-1-102-1-102-1-102-1-102-1-102-1-102-1-102-1-102-1-102-1-102-1-102-1-102-1-102-1-102-1-102-1-102-1-102-1-102-1-102-1-102-1-102-1-102-1-102-1-102-1-102-1-102-1-102-1-102-1-102-1-102-1-1
09010709030609030709010809010902-1-102-1-102-1-102-1-102-1-102-1-102-1-102-1-102-1-102-1-102-1-102-1-102-1-102-1-102-1-102-1-102-1-102-1-102-1-102-1-102-1-102-1-102-1-102-1-102-1-102-1-102-1-102-1-102-1-102-1-102-1-102-1-102-1-102-1-102-1-102-1-102-1-102-1-102-1-102-1-102-1-102-1-102-1-102-1-102-1-102-1-102-1-102-1-102-1-102-1-102-1-102-1-102-1-102-1-102-1-102-1-102-1-102-1-102-1-102-1-102-1-102-1-102-1-102-1-102-1-102-1-102-1-102-1-102-1-102-1-102-1-102-1-102-1-102-1-102-1-1
09020709020609020709020809020902-1-102-1-102-1-102-1-102-1-102-1-102-1-102-1-102-1-102-1-102-1-102-1-102-1-102-1-102-1-102-1-102-1-102-1-102-1-102-1-102-1-102-1-102-1-102-1-102-1-102-1-102-1-102-1-102-1-102-1-102-1-102-1-102-1-102-1-102-1-102-1-102-1-102-1-102-1-102-1-102-1-102-1-102-1-102-1-102-1-102-1-102-1-102-1-102-1-102-1-102-1-102-1-102-1-102-1-102-1-102-1-102-1-102-1-102-1-102-1-102-1-102-1-102-1-102-1-102-1-102-1-102-1-102-1-102-1-102-1-102-1-102-1-102-1-102-1-102-1-1
09030509030609030709030809030902-1-102-1-102-1-102-1-102-1-102-1-102-1-102-1-102-1-102-1-102-1-102-1-102-1-102-1-102-1-102-1-102-1-102-1-102-1-102-1-102-1-102-1-102-1-102-1-102-1-102-1-102-1-102-1-102-1-102-1-102-1-102-1-102-1-102-1-102-1-102-1-102-1-102-1-102-1-102-1-102-1-102-1-102-1-102-1-102-1-102-1-102-1-102-1-102-1-102-1-102-1-102-1-102-1-102-1-102-1-102-1-102-1-102-1-102-1-102-1-102-1-102-1-102-1-102-1-102-1-102-1-102-1-102-1-102-1-102-1-102-1-102-1-102-1-102-1-102-1-1
09040509040609040709040809040902-1-102-1-102-1-102-1-102-1-102-1-102-1-102-1-102-1-102-1-102-1-102-1-102-1-102-1-102-1-102-1-102-1-102-1-102-1-102-1-102-1-102-1-102-1-102-1-102-1-102-1-102-1-102-1-102-1-102-1-102-1-102-1-102-1-102-1-102-1-102-1-102-1-102-1-102-1-102-1-102-1-102-1-102-1-102-1-102-1-102-1-102-1-102-1-102-1-102-1-102-1-102-1-102-1-102-1-102-1-102-1-102-1-102-1-102-1-102-1-102-1-102-1-102-1-102-1-102-1-102-1-102-1-102-1-102-1-102-1-102-1-102-1-102-1-102-1-102-1-1
02-1-102-1-102-1-102-1-102-1-102-1-102-1-102-1-102-1-102-1-102-1-102-1-102-1-102-1-102-1-102-1-102-1-102-1-102-1-102-1-102-1-102-1-102-1-102-1-102-1-102-1-102-1-102-1-102-1-102-1-102-1-102-1-102-1-102-1-102-1-102-1-102-1-102-1-102-1-102-1-102-1-102-1-102-1-102-1-102-1-102-1-102-1-102-1-102-1-102-1-102-1-102-1-102-1-102-1-102-1-102-1-102-1-102-1-102-1-102-1-102-1-102-1-102-1-102-1-102-1-102-1-102-1-102-1-102-1-102-1-102-1-102-1-102-1-102-1-102-1-102-1-102-1-102-1-102-1-102-1-1
02-1-102-1-102-1-102-1-102-1-102-1-102-1-102-1-102-1-102-1-102-1-102-1-102-1-102-1-102-1-102-1-102-1-102-1-102-1-102-1-102-1-102-1-102-1-102-1-102-1-102-1-102-1-102-1-102-1-102-1-102-1-102-1-102-1-102-1-102-1-102-1-102-1-102-1-102-1-102-1-102-1-102-1-102-1-102-1-102-1-102-1-102-1-102-1-102-1-102-1-102-1-102-1-102-1-102-1-102-1-102-1-102-1-102-1-102-1-102-1-102-1-102-1-102-1-102-1-102-1-102-1-102-1-102-1-102-1-102-1-102-1-102-1-102-1-102-1-102-1-102-1-102-1-102-1-102-1-102-1-1
02-1-102-1-102-1-102-1-102-1-102-1-102-1-102-1-102-1-102-1-102-1-102-1-102-1-102-1-102-1-102-1-102-1-102-1-102-1-102-1-102-1-102-1-102-1-102-1-102-1-102-1-102-1-102-1-102-1-102-1-102-1-102-1-102-1-102-1-102-1-102-1-102-1-102-1-102-1-102-1-102-1-102-1-102-1-102-1-102-1-102-1-102-1-102-1-102-1-102-1-102-1-102-1-102-1-102-1-102-1-102-1-102-1-102-1-102-1-102-1-102-1-102-1-102-1-102-1-102-1-102-1-102-1-102-1-102-1-102-1-102-1-102-1-102-1-102-1-102-1-102-1-102-1-102-1-102-1-102-1-1
02-1-102-1-102-1-102-1-102-1-102-1-102-1-102-1-102-1-102-1-102-1-102-1-102-1-102-1-102-1-102-1-102-1-102-1-102-1-102-1-102-1-102-1-102-1-102-1-102-1-102-1-102-1-102-1-102-1-102-1-102-1-102-1-102-1-102-1-102-1-102-1-102-1-102-1-102-1-102-1-102-1-102-1-102-1-102-1-102-1-102-1-102-1-102-1-102-1-102-1-102-1-102-1-102-1-102-1-102-1-102-1-102-1-102-1-102-1-102-1-102-1-102-1-102-1-102-1-102-1-102-1-102-1-102-1-102-1-102-1-102-1-102-1-102-1-102-1-102-1-102-1-102-1-102-1-102-1-102-1-1
02-1-102-1-102-1-102-1-102-1-102-1-102-1-102-1-102-1-102-1-102-1-102-1-102-1-102-1-102-1-102-1-102-1-102-1-102-1-102-1-102-1-102-1-102-1-102-1-102-1-102-1-102-1-102-1-102-1-102-1-102-1-102-1-102-1-102-1-102-1-102-1-102-1-102-1-102-1-102-1-102-1-102-1-102-1-102-1-102-1-102-1-102-1-102-1-102-1-102-1-102-1-102-1-102-1-102-1-102-1-102-1-102-1-102-1-102-1-102-1-102-1-102-1-102-1-102-1-102-1-102-1-102-1-102-1-102-1-102-1-102-1-102-1-102-1-102-1-102-1-102-1-102-1-102-1-102-1-102-1-1
02-1-102-1-102-1-102-1-102-1-102-1-102-1-102-1-102-1-102-1-102-1-102-1-102-1-102-1-102-1-102-1-102-1-102-1-102-1-102-1-102-1-102-1-102-1-102-1-102-1-102-1-102-1-102-1-102-1-102-1-102-1-102-1-102-1-102-1-102-1-102-1-102-1-102-1-102-1-102-1-102-1-102-1-102-1-102-1-102-1-102-1-102-1-102-1-102-1-102-1-102-1-102-1-102-1-102-1-102-1-102-1-102-1-102-1-102-1-102-1-102-1-102-1-102-1-102-1-102-1-102-1-102-1-102-1-102-1-102-1-102-1-102-1-102-1-102-1-102-1-102-1-102-1-102-1-102-1-102-1-1
02-1-102-1-102-1-102-1-102-1-102-1-102-1-102-1-102-1-102-1-102-1-102-1-102-1-102-1-102-1-102-1-102-1-102-1-102-1-102-1-102-1-102-1-102-1-102-1-102-1-102-1-102-1-102-1-102-1-102-1-102-1-102-1-102-1-102-1-102-1-102-1-102-1-102-1-102-1-102-1-102-1-102-1-102-1-102-1-102-1-102-1-102-1-102-1-102-1-102-1-102-1-102-1-102-1-102-1-102-1-102-1-102-1-102-1-102-1-102-1-102-1-102-1-102-1-102-1-102-1-102-1-102-1-102-1-102-1-102-1-102-1-102-1-102-1-102-1-102-1-102-1-102-1-102-1-102-1-102-1-1
02-1-102-1-102-1-102-1-102-1-102-1-102-1-102-1-102-1-102-1-102-1-102-1-102-1-102-1-102-1-102-1-102-1-102-1-102-1-102-1-102-1-102-1-102-1-102-1-102-1-102-1-102-1-102-1-102-1-102-1-102-1-102-1-102-1-102-1-102-1-102-1-102-1-102-1-102-1-102-1-102-1-102-1-102-1-102-1-102-1-102-1-102-1-102-1-102-1-102-1-102-1-102-1-102-1-102-1-102-1-102-1-102-1-102-1-102-1-102-1-102-1-102-1-102-1-102-1-102-1-102-1-102-1-102-1-102-1-102-1-102-1-102-1-102-1-102-1-102-1-102-1-102-1-102-1-102-1-102-1-1
02-1-102-1-102-1-102-1-102-1-102-1-102-1-102-1-102-1-102-1-102-1-102-1-102-1-102-1-102-1-102-1-102-1-102-1-102-1-102-1-102-1-102-1-102-1-102-1-102-1-102-1-102-1-102-1-102-1-102-1-102-1-102-1-102-1-102-1-102-1-102-1-102-1-102-1-102-1-102-1-102-1-102-1-102-1-102-1-102-1-102-1-102-1-102-1-102-1-102-1-102-1-102-1-102-1-102-1-102-1-102-1-102-1-102-1-102-1-102-1-102-1-102-1-102-1-102-1-102-1-102-1-102-1-102-1-102-1-102-1-102-1-102-1-102-1-102-1-102-1-102-1-102-1-102-1-102-1-102-1-1
02-1-102-1-102-1-102-1-102-1-102-1-102-1-102-1-102-1-102-1-102-1-102-1-102-1-102-1-102-1-102-1-102-1-102-1-102-1-102-1-102-1-102-1-102-1-102-1-102-1-102-1-102-1-102-1-102-1-102-1-102-1-102-1-102-1-102-1-102-1-102-1-102-1-102-1-102-1-102-1-102-1-102-1-102-1-102-1-102-1-102-1-102-1-102-1-102-1-102-1-102-1-102-1-102-1-102-1-102-1-102-1-102-1-102-1-102-1-102-1-102-1-102-1-102-1-102-1-102-1-102-1-102-1-102-1-102-1-102-1-102-1-102-1-102-1-102-1-102-1-102-1-102-1-102-1-102-1-102-1-1
02-1-102-1-102-1-102-1-102-1-102-1-102-1-102-1-102-1-102-1-102-1-102-1-102-1-102-1-102-1-102-1-102-1-102-1-102-1-102-1-102-1-102-1-102-1-102-1-102-1-102-1-102-1-102-1-102-1-102-1-102-1-102-1-102-1-102-1-102-1-102-1-102-1-102-1-102-1-102-1-102-1-102-1-102-1-102-1-102-1-102-1-102-1-102-1-102-1-102-1-102-1-102-1-102-1-102-1-102-1-102-1-102-1-102-1-102-1-102-1-102-1-102-1-102-1-102-1-102-1-102-1-102-1-102-1-102-1-102-1-102-1-102-1-102-1-102-1-102-1-102-1-102-1-102-1-102-1-102-1-1
02-1-102-1-102-1-102-1-102-1-102-1-102-1-102-1-102-1-102-1-102-1-102-1-102-1-102-1-102-1-102-1-102-1-102-1-102-1-102-1-102-1-102-1-102-1-102-1-102-1-102-1-102-1-102-1-102-1-102-1-102-1-102-1-102-1-102-1-102-1-102-1-102-1-102-1-102-1-102-1-102-1-102-1-102-1-102-1-102-1-102-1-102-1-102-1-102-1-102-1-102-1-102-1-102-1-102-1-102-1-102-1-102-1-102-1-102-1-102-1-102-1-102-1-102-1-102-1-102-1-102-1-102-1-102-1-102-1-102-1-102-1-102-1-102-1-102-1-102-1-102-1-102-1-102-1-102-1-102-1-1
02-1-102-1-102-1-102-1-102-1-102-1-102-1-102-1-102-1-102-1-102-1-102-1-102-1-102-1-102-1-102-1-102-1-102-1-102-1-102-1-102-1-102-1-102-1-102-1-102-1-102-1-102-1-102-1-102-1-102-1-102-1-102-1-102-1-102-1-102-1-102-1-102-1-102-1-102-1-102-1-102-1-102-1-102-1-102-1-102-1-102-1-102-1-102-1-102-1-102-1-102-1-102-1-102-1-102-1-102-1-102-1-102-1-102-1-102-1-102-1-102-1-102-1-102-1-102-1-102-1-102-1-102-1-102-1-102-1-102-1-102-1-102-1-102-1-102-1-102-1-102-1-102-1-102-1-102-1-102-1-1
02-1-102-1-102-1-102-1-102-1-102-1-102-1-102-1-102-1-102-1-102-1-102-1-102-1-102-1-102-1-102-1-102-1-102-1-102-1-102-1-102-1-102-1-102-1-102-1-102-1-102-1-102-1-102-1-102-1-102-1-102-1-102-1-102-1-102-1-102-1-102-1-102-1-102-1-102-1-102-1-102-1-102-1-102-1-102-1-102-1-102-1-102-1-102-1-102-1-102-1-102-1-102-1-102-1-102-1-102-1-102-1-102-1-102-1-102-1-102-1-102-1-102-1-102-1-102-1-102-1-102-1-102-1-102-1-102-1-102-1-102-1-102-1-102-1-102-1-102-1-102-1-102-1-102-1-102-1-102-1-1
02-1-102-1-102-1-102-1-102-1-102-1-102-1-102-1-102-1-102-1-102-1-102-1-102-1-102-1-102-1-102-1-102-1-102-1-102-1-102-1-102-1-102-1-102-1-102-1-102-1-102-1-102-1-102-1-102-1-102-1-102-1-102-1-102-1-102-1-102-1-102-1-102-1-102-1-102-1-102-1-102-1-102-1-102-1-102-1-102-1-102-1-102-1-102-1-102-1-102-1-102-1-102-1-102-1-102-1-102-1-102-1-102-1-102-1-102-1-102-1-102-1-102-1-102-1-102-1-102-1-102-1-102-1-102-1-102-1-102-1-102-1-102-1-102-1-102-1-102-1-102-1-102-1-102-1-102-1-102-1-1
02-1-102-1-102-1-102-1-102-1-102-1-102-1-102-1-102-1-102-1-102-1-102-1-102-1-102-1-102-1-102-1-102-1-102-1-102-1-102-1-102-1-102-1-102-1-102-1-102-1-102-1-102-1-102-1-102-1-102-1-102-1-102-1-102-1-102-1-102-1-102-1-102-1-102-1-102-1-102-1-102-1-102-1-102-1-102-1-102-1-102-1-102-1-102-1-102-1-102-1-102-1-102-1-102-1-102-1-102-1-102-1-102-1-102-1-102-1-102-1-102-1-102-1-102-1-102-1-102-1-102-1-102-1-102-1-102-1-102-1-102-1-102-1-102-1-102-1-102-1-102-1-102-1-102-1-102-1-102-1-1
02-1-102-1-102-1-102-1-102-1-102-1-102-1-102-1-102-1-102-1-102-1-102-1-102-1-102-1-102-1-102-1-102-1-102-1-102-1-102-1-102-1-102-1-102-1-102-1-102-1-102-1-102-1-102-1-102-1-102-1-102-1-102-1-102-1-102-1-102-1-102-1-102-1-102-1-102-1-102-1-102-1-102-1-102-1-102-1-102-1-102-1-102-1-102-1-102-1-102-1-102-1-102-1-102-1-102-1-102-1-102-1-102-1-102-1-102-1-102-1-102-1-102-1-102-1-102-1-102-1-102-1-102-1-102-1-102-1-102-1-102-1-102-1-102-1-102-1-102-1-102-1-102-1-102-1-102-1-102-1-1
