63
51
011111111111111111111111111110000000000001111111111111111010000
011111111111111111111111111110000000000001111111111111111010100
011111111111111111111111111110000000000001111111111111111010100
011111111111111111111111111110000000000001111111111111111010100
011111111111111111111111111111100000000011111111111111111110100
011111111111111111111111111111100000000011111111111111111110100
011000000000000000000000000000000000000000000000000000000010100
011000000000000000000000000000000000000000000000000000000010100
011000000000000000000000000000000000000000000000000000000010100
011000000000000000000000000000000000000000000000000000000010100
011000000000000000000000000000000000000000000000000000000010100
011000000000000000000000000000000000000000000000000000000010100
011000000000000000000000000000000000000000000000000000000010100
011000000000000000000000000000000000000000000000000000000010100
011000000000001000000000000000000000000000000000000000000010100
011000000000000000000000000000000000000000000000000000000010100
011000000000000000000000000000000000000000000000000000000010100
011000000000000000000000000000000000000000000000000000000010100
011000000000000000000000000000000000000000000000000000000010100
011000000000000000000000000000000000000000000000000000000010100
011000000000000000000000000000000000000000000000000000000010100
011000000000000000000000000000000000000000000000000000000010100
111110000000000000000000000000000000000000000000000000000011111
111110000000000000000000000000000000000000000000000000000011111
000000000000000000000000000000000000000000000000000000000000000
000000000000000000000000000000000000000000000000000000000000000
000000000000000000000000000000000000000000000000000000000000000
000000000000000000000000000000000000000000000000000000000000000
000000000000000000000000000000000000000000000000000000000000000
000000000000000000000000000000000000000000000000000000000000000
000000000000000000000000000000000000000000000000000000000000000
000000000000000000000000000000000000000000000000000000000000000
000000000000000000000000000000000000000000000000000000000000000
000000000000000000000000000000000000000000000000000000000000000
000000000000000000000000000000000000000000000000000000000000000
000000000000000000000000000000000000000000000000000000000000000
000000000000000000000000000000000000000000000000000000000000000
000000000000000000000000000000000000000000000000000000000000000
000000000000000000000000000000000000000000000000000000000000000
000000000000000000000000000000000000000000000000000000000000000
000000000000000000000000000000000000000000000000000000000000000
000000000000000000000000000000000000000000000000000000000000000
000000000000000000000000000000000000000000000000000000000000000
000000000000000000000000000000000000000000000000000000000000000
000000000000000000000000000000000000000000000000000000000000000
000000000000000000000000000000000000000000000000000000000000000
000000000000000000000000000000000000000000000000000000000000000
000000000000000000000000000000000000000000000000000000000000000
000000000000000000000000000000000000000000000000000000000000000
000000000000000000000000000000000000000000000000000000000000000
000000000000000000000000000000000000000000000000000000000000000
