40
40
000-10-1000-10-1000-10-1000-10-1000-10-1000-10-1000-10-1000-10-1020-10-1020-10-1020-10-1020-10-1020-10-1020-10-1020-10-1020-10-1020-10-1020-10-1020-10-1020-10-1020-10-1020-10-1020-10-1020-10-1020-10-1020-10-1020-10-1020-10-1020-10-1020-10-1020-10-1020-10-1020-10-1020-10-1020-10-1020-10-1020-10-1020-10-1020-10-1020-10-1
000-10-1000-10-1000-10-1000-10-1000-10-1000-10-1000-10-1000-10-1020-10-1020-10-1020-10-1020-10-1020-10-1020-10-1020-10-1020-10-1020-10-1020-10-1020-10-1020-10-1020-10-1020-10-1020-10-1020-10-1020-10-1020-10-1020-10-1020-10-1020-10-1020-10-1020-10-1020-10-1020-10-1020-10-1020-10-1020-10-1020-10-1020-10-1020-10-1020-10-1
000-10-1000-10-1000-10-1000-10-1000-10-1000-10-1000-10-1000-10-1020-10-1020-10-1020-10-1020-10-1020-10-1020-10-1020-10-1020-10-1020-10-1020-10-1020-10-1020-10-1020-10-1020-10-1020-10-1020-10-1020-10-1020-10-1020-10-1020-10-1020-10-1020-10-1020-10-1020-10-1020-10-1020-10-1020-10-1020-10-1020-10-1020-10-1020-10-1020-10-1
000-10-1000-10-1000-10-1000-10-1000-10-1020-10-1000-10-1000-10-1020-10-1020-10-1020-10-1020-10-1020-10-1020-10-1020-10-1020-10-1020-10-1020-10-1020-10-1020-10-1020-10-1020-10-1020-10-1020-10-1020-10-1020-10-1020-10-1020-10-1020-10-1020-10-1020-10-1020-10-1020-10-1020-10-1020-10-1020-10-1020-10-1020-10-1020-10-1020-10-1
000-10-1000-10-1000-10-1000-10-1000-10-1020-10-1000-10-1020-10-1000-10-1020-10-1020-10-1020-10-1020-10-1020-10-1020-10-1020-10-1020-10-1020-10-1020-10-1020-10-1020-10-1020-10-1020-10-1020-10-1020-10-1020-10-1020-10-1020-10-1020-10-1020-10-1020-10-1020-10-1020-10-1020-10-1020-10-1020-10-1020-10-1020-10-1020-10-1020-10-1
000-10-1000-10-1000-10-1020-10-1000-10-1020-10-1020-10-1000-10-1020-10-1020-10-1020-10-1020-10-1020-10-1020-10-1020-10-1020-10-1020-10-1020-10-1020-10-1020-10-1020-10-1020-10-1020-10-1020-10-1020-10-1020-10-1020-10-1020-10-1020-10-1020-10-1020-10-1020-10-1020-10-1020-10-1020-10-1020-10-1020-10-1020-10-1020-10-1020-10-1
000-10-1000-10-1000-10-1000-10-1020-10-1000-10-1000-10-1020-10-1020-10-1020-10-1020-10-1020-10-1020-10-1020-10-1020-10-1020-10-1020-10-1020-10-1020-10-1020-10-1020-10-1020-10-1020-10-1020-10-1020-10-1020-10-1020-10-1020-10-1020-10-1020-10-1020-10-1020-10-1020-10-1020-10-1020-10-1020-10-1020-10-1020-10-1020-10-1020-10-1
000-10-1000-10-1000-10-1000-10-1000-10-1000-10-1020-10-1020-10-1020-10-1020-10-1020-10-1020-10-1020-10-1020-10-1020-10-1020-10-1020-10-1020-10-1020-10-1020-10-1020-10-1020-10-1020-10-1020-10-1020-10-1020-10-1020-10-1020-10-1020-10-1020-10-1020-10-1020-10-1020-10-1020-10-1020-10-1020-10-1020-10-1020-10-1020-10-1020-10-1
000-10-1000-10-1000-10-1000-10-1000-10-1000-10-1020-10-1020-10-1020-10-1020-10-1020-10-1020-10-1020-10-1020-10-1020-10-1020-10-1020-10-1020-10-1020-10-1020-10-1020-10-1020-10-1020-10-1020-10-1020-10-1020-10-1020-10-1020-10-1020-10-1020-10-1020-10-1020-10-1020-10-1020-10-1020-10-1020-10-1020-10-1020-10-1020-10-1020-10-1
000-10-1000-10-1000-10-1000-10-1000-10-1000-10-1000-10-1020-10-1020-10-1020-10-1020-10-1020-10-1020-10-1020-10-1020-10-1020-10-1020-10-1020-10-1020-10-1020-10-1020-10-1020-10-1020-10-1020-10-1020-10-1020-10-1020-10-1020-10-1020-10-1020-10-1020-10-1020-10-1020-10-1020-10-1020-10-1020-10-1020-10-1020-10-1020-10-1020-10-1
000-10-1000-10-1000-10-1000-10-1000-10-1020-10-1020-10-1020-10-1020-10-1020-10-1020-10-1020-10-1020-10-1020-10-1020-10-1020-10-1020-10-1020-10-1020-10-1020-10-1020-10-1020-10-1020-10-1020-10-1020-10-1020-10-1020-10-1020-10-1020-10-1020-10-1020-10-1020-10-1020-10-1020-10-1020-10-1020-10-1020-10-1020-10-1020-10-1020-10-1
000-10-1000-10-1000-10-1000-10-1000-10-1000-10-1020-10-1020-10-1020-10-1020-10-1020-10-1020-10-1020-10-1020-10-1020-10-1020-10-1020-10-1020-10-1020-10-1020-10-1020-10-1020-10-1020-10-1020-10-1020-10-1020-10-1020-10-1020-10-1020-10-1020-10-1020-10-1020-10-1020-10-1020-10-1020-10-1020-10-1020-10-1020-10-1020-10-1020-10-1
000-10-1000-10-1000-10-1000-10-1000-10-1000-10-1020-10-1020-10-1020-10-1020-10-1020-10-1020-10-1020-10-1020-10-1020-10-1020-10-1020-10-1020-10-1020-10-1020-10-1020-10-1020-10-1020-10-1020-10-1020-10-1020-10-1020-10-1020-10-1020-10-1020-10-1020-10-1020-10-1020-10-1020-10-1020-10-1020-10-1020-10-1020-10-1020-10-1020-10-1
000-10-1000-10-1000-10-1000-10-1000-10-1020-10-1020-10-1020-10-1020-10-1020-10-1020-10-1020-10-1020-10-1020-10-1020-10-1020-10-1020-10-1020-10-1020-10-1020-10-1020-10-1020-10-1020-10-1020-10-1020-10-1020-10-1020-10-1020-10-1020-10-1020-10-1020-10-1020-10-1020-10-1020-10-1020-10-1020-10-1020-10-1020-10-1020-10-1020-10-1
000-10-1000-10-1000-10-1000-10-1000-10-1020-10-1020-10-1020-10-1020-10-1020-10-1020-10-1020-10-1020-10-1020-10-1020-10-1020-10-1020-10-1020-10-1020-10-1020-10-1020-10-1020-10-1020-10-1020-10-1020-10-1020-10-1020-10-1020-10-1020-10-1020-10-1020-10-1020-10-1020-10-1020-10-1020-10-1020-10-1020-10-1020-10-1020-10-1020-10-1
000-10-1000-10-1000-10-1000-10-1000-10-1000-10-1020-10-1020-10-1020-10-1020-10-1020-10-1020-10-1020-10-1020-10-1020-10-1020-10-1020-10-1020-10-1020-10-1020-10-1020-10-1020-10-1020-10-1020-10-1020-10-1020-10-1020-10-1020-10-1020-10-1020-10-1020-10-1020-10-1020-10-1020-10-1020-10-1020-10-1020-10-1020-10-1020-10-1020-10-1
000-10-1000-10-1000-10-1000-10-1020-10-1020-10-1020-10-1020-10-1020-10-1020-10-1020-10-1020-10-1020-10-1020-10-1020-10-1020-10-1020-10-1020-10-1020-10-1020-10-1020-10-1020-10-1020-10-1020-10-1020-10-1020-10-1020-10-1020-10-1020-10-1020-10-1020-10-1020-10-1020-10-1020-10-1020-10-1020-10-1020-10-1020-10-1020-10-1020-10-1
000-10-1000-10-1000-10-1000-10-1000-10-1020-10-1000-10-1000-10-1020-10-1020-10-1020-10-1020-10-1020-10-1020-10-1020-10-1020-10-1020-10-1020-10-1020-10-1020-10-1020-10-1020-10-1020-10-1020-10-1020-10-1020-10-1020-10-1020-10-1020-10-1020-10-1020-10-1020-10-1020-10-1020-10-1020-10-1020-10-1020-10-1020-10-1020-10-1020-10-1
000-10-1000-10-1000-10-1000-10-1020-10-1000-10-1020-10-1020-10-1020-10-1020-10-1020-10-1020-10-1020-10-1020-10-1020-10-1020-10-1020-10-1020-10-1020-10-1020-10-1020-10-1020-10-1020-10-1020-10-1020-10-1020-10-1020-10-1020-10-1020-10-1020-10-1020-10-1020-10-1020-10-1020-10-1020-10-1020-10-1020-10-1020-10-1020-10-1020-10-1
000-10-1000-10-1000-10-1020-10-1000-10-1000-10-1020-10-1020-10-1020-10-1020-10-1020-10-1020-10-1020-10-1020-10-1020-10-1020-10-1020-10-1020-10-1020-10-1020-10-1020-10-1020-10-1020-10-1020-10-1020-10-1020-10-1020-10-1020-10-1020-10-1020-10-1020-10-1020-10-1020-10-1020-10-1020-10-1020-10-1020-10-1020-10-1020-10-1020-10-1
000-10-1000-10-1000-10-1000-10-1000-10-1020-10-1020-10-1020-10-1020-10-1020-10-1020-10-1020-10-1020-10-1020-10-1020-10-1020-10-1020-10-1020-10-1020-10-1020-10-1020-10-1020-10-1020-10-1020-10-1020-10-1020-10-1020-10-1020-10-1020-10-1020-10-1020-10-1020-10-1020-10-1020-10-1020-10-1020-10-1020-10-1020-10-1020-10-1020-10-1
020-10-1020-10-1000-10-1000-10-1000-10-1020-10-1020-10-1020-10-1020-10-1020-10-1020-10-1020-10-1020-10-1020-10-1020-10-1020-10-1020-10-1020-10-1020-10-1020-10-1020-10-1020-10-1020-10-1020-10-1020-10-1020-10-1020-10-1020-10-1020-10-1020-10-1020-10-1020-10-1020-10-1020-10-1020-10-1020-10-1020-10-1020-10-1020-10-1020-10-1
000-10-1000-10-1000-10-1020-10-1020-10-1020-10-1020-10-1020-10-1020-10-1020-10-1020-10-1020-10-1020-10-1020-10-1020-10-1020-10-1020-10-1020-10-1020-10-1020-10-1020-10-1020-10-1020-10-1020-10-1020-10-1020-10-1020-10-1020-10-1020-10-1020-10-1020-10-1020-10-1020-10-1020-10-1020-10-1020-10-1020-10-1020-10-1020-10-1020-10-1
020-10-1020-10-1000-10-1020-10-1020-10-1020-10-1020-10-1020-10-1020-10-1020-10-1020-10-1020-10-1020-10-1020-10-1020-10-1020-10-1020-10-1020-10-1020-10-1020-10-1020-10-1020-10-1020-10-1020-10-1020-10-1020-10-1020-10-1020-10-1020-10-1020-10-1020-10-1020-10-1020-10-1020-10-1020-10-1020-10-1020-10-1020-10-1020-10-1020-10-1
020-10-1020-10-1020-10-1020-10-1020-10-1020-10-1020-10-1020-10-1020-10-1020-10-1020-10-1020-10-1020-10-1020-10-1020-10-1020-10-1020-10-1020-10-1020-10-1020-10-1020-10-1020-10-1020-10-1020-10-1020-10-1020-10-1020-10-1020-10-1020-10-1020-10-1020-10-1020-10-1020-10-1020-10-1020-10-1020-10-1020-10-1020-10-1020-10-1020-10-1
020-10-1020-10-1020-10-1020-10-1020-10-1020-10-1020-10-1020-10-1020-10-1020-10-1020-10-1020-10-1020-10-1020-10-1020-10-1020-10-1020-10-1020-10-1020-10-1020-10-1020-10-1020-10-1020-10-1020-10-1020-10-1020-10-1020-10-1020-10-1020-10-1020-10-1020-10-1020-10-1020-10-1020-10-1020-10-1020-10-1020-10-1020-10-1020-10-1020-10-1
020-10-1020-10-1020-10-1020-10-1020-10-1020-10-1020-10-1020-10-1020-10-1020-10-1020-10-1020-10-1020-10-1020-10-1020-10-1020-10-1020-10-1020-10-1020-10-1020-10-1020-10-1020-10-1020-10-1020-10-1020-10-1020-10-1020-10-1020-10-1020-10-1020-10-1020-10-1020-10-1020-10-1020-10-1020-10-1020-10-1020-10-1020-10-1020-10-1020-10-1
020-10-1020-10-1020-10-1020-10-1020-10-1020-10-1020-10-1020-10-1020-10-1020-10-1020-10-1020-10-1020-10-1020-10-1020-10-1020-10-1020-10-1020-10-1020-10-1020-10-1020-10-1020-10-1020-10-1020-10-1020-10-1020-10-1020-10-1020-10-1020-10-1020-10-1020-10-1020-10-1020-10-1020-10-1020-10-1020-10-1020-10-1020-10-1020-10-1020-10-1
020-10-1020-10-1020-10-1020-10-1020-10-1020-10-1020-10-1020-10-1020-10-1020-10-1020-10-1020-10-1020-10-1020-10-1020-10-1020-10-1020-10-1020-10-1020-10-1020-10-1020-10-1020-10-1020-10-1020-10-1020-10-1020-10-1020-10-1020-10-1020-10-1020-10-1020-10-1020-10-1020-10-1020-10-1020-10-1020-10-1020-10-1020-10-1020-10-1020-10-1
020-10-1020-10-1020-10-1020-10-1020-10-1020-10-1020-10-1020-10-1020-10-1020-10-1020-10-1020-10-1020-10-1020-10-1020-10-1020-10-1020-10-1020-10-1020-10-1020-10-1020-10-1020-10-1020-10-1020-10-1020-10-1020-10-1020-10-1020-10-1020-10-1020-10-1020-10-1020-10-1020-10-1020-10-1020-10-1020-10-1020-10-1020-10-1020-10-1020-10-1
020-10-1020-10-1020-10-1020-10-1020-10-1020-10-1020-10-1020-10-1020-10-1020-10-1020-10-1020-10-1020-10-1020-10-1020-10-1020-10-1020-10-1020-10-1020-10-1020-10-1020-10-1020-10-1020-10-1020-10-1020-10-1020-10-1020-10-1020-10-1020-10-1020-10-1020-10-1020-10-1020-10-1020-10-1020-10-1020-10-1020-10-1020-10-1020-10-1020-10-1
020-10-1020-10-1020-10-1020-10-1020-10-1020-10-1020-10-1020-10-1020-10-1020-10-1020-10-1020-10-1020-10-1020-10-1020-10-1020-10-1020-10-1020-10-1020-10-1020-10-1020-10-1020-10-1020-10-1020-10-1020-10-1020-10-1020-10-1020-10-1020-10-1020-10-1020-10-1020-10-1020-10-1020-10-1020-10-1020-10-1020-10-1020-10-1020-10-1020-10-1
020-10-1020-10-1020-10-1020-10-1020-10-1020-10-1020-10-1020-10-1020-10-1020-10-1020-10-1020-10-1020-10-1020-10-1020-10-1020-10-1020-10-1020-10-1020-10-1020-10-1020-10-1020-10-1020-10-1020-10-1020-10-1020-10-1020-10-1020-10-1020-10-1020-10-1020-10-1020-10-1020-10-1020-10-1020-10-1020-10-1020-10-1020-10-1020-10-1020-10-1
020-10-1020-10-1020-10-1020-10-1020-10-1020-10-1020-10-1020-10-1020-10-1020-10-1020-10-1020-10-1020-10-1020-10-1020-10-1020-10-1020-10-1020-10-1020-10-1020-10-1020-10-1020-10-1020-10-1020-10-1020-10-1020-10-1020-10-1020-10-1020-10-1020-10-1020-10-1020-10-1020-10-1020-10-1020-10-1020-10-1020-10-1020-10-1020-10-1020-10-1
020-10-1020-10-1020-10-1020-10-1020-10-1020-10-1020-10-1020-10-1020-10-1020-10-1020-10-1020-10-1020-10-1020-10-1020-10-1020-10-1020-10-1020-10-1020-10-1020-10-1020-10-1020-10-1020-10-1020-10-1020-10-1020-10-1020-10-1020-10-1020-10-1020-10-1020-10-1020-10-1020-10-1020-10-1020-10-1020-10-1020-10-1020-10-1020-10-1020-10-1
020-10-1020-10-1020-10-1020-10-1020-10-1020-10-1020-10-1020-10-1020-10-1020-10-1020-10-1020-10-1020-10-1020-10-1020-10-1020-10-1020-10-1020-10-1020-10-1020-10-1020-10-1020-10-1020-10-1020-10-1020-10-1020-10-1020-10-1020-10-1020-10-1020-10-1020-10-1020-10-1020-10-1020-10-1020-10-1020-10-1020-10-1020-10-1020-10-1020-10-1
020-10-1020-10-1020-10-1020-10-1020-10-1020-10-1020-10-1020-10-1020-10-1020-10-1020-10-1020-10-1020-10-1020-10-1020-10-1020-10-1020-10-1020-10-1020-10-1020-10-1020-10-1020-10-1020-10-1020-10-1020-10-1020-10-1020-10-1020-10-1020-10-1020-10-1020-10-1020-10-1020-10-1020-10-1020-10-1020-10-1020-10-1020-10-1020-10-1020-10-1
020-10-1020-10-1020-10-1020-10-1020-10-1020-10-1020-10-1020-10-1020-10-1020-10-1020-10-1020-10-1020-10-1020-10-1020-10-1020-10-1020-10-1020-10-1020-10-1020-10-1020-10-1020-10-1020-10-1020-10-1020-10-1020-10-1020-10-1020-10-1020-10-1020-10-1020-10-1020-10-1020-10-1020-10-1020-10-1020-10-1020-10-1020-10-1020-10-1020-10-1
020-10-1020-10-1020-10-1020-10-1020-10-1020-10-1020-10-1020-10-1020-10-1020-10-1020-10-1020-10-1020-10-1020-10-1020-10-1020-10-1020-10-1020-10-1020-10-1020-10-1020-10-1020-10-1020-10-1020-10-1020-10-1020-10-1020-10-1020-10-1020-10-1020-10-1020-10-1020-10-1020-10-1020-10-1020-10-1020-10-1020-10-1020-10-1020-10-1020-10-1
020-10-1020-10-1020-10-1020-10-1020-10-1020-10-1020-10-1020-10-1020-10-1020-10-1020-10-1020-10-1020-10-1020-10-1020-10-1020-10-1020-10-1020-10-1020-10-1020-10-1020-10-1020-10-1020-10-1020-10-1020-10-1020-10-1020-10-1020-10-1020-10-1020-10-1020-10-1020-10-1020-10-1020-10-1020-10-1020-10-1020-10-1020-10-1020-10-1020-10-1
