63
51
02-1-109050609050709050609050709050609050709050609050709050609050709050609050709050609050709050609050709050609050709050609050709050609050709050609050709050609050709050609050702-1-102-1-102-1-102-1-102-1-102-1-102-1-102-1-102-1-102-1-102-1-102-1-109050609050709050609050709050609050709050609050709050609050709050609050709050609050709050609050702-1-101040102-1-102-1-102-1-102-1-1
02-1-109060609060709060609060709060609060709060609060709060609060709060609060709060609060709060609060709060609060709060609060709060609060709060609060709060609060709060609060702-1-102-1-102-1-102-1-102-1-102-1-102-1-102-1-102-1-102-1-102-1-102-1-109060609060709060609060709060609060709060609060709060609060709060609060709060609060709060609060702-1-101040102-1-101040102-1-102-1-1
02-1-109050609050709050609050709050609050709050609050709050609050709050609050709050609050709050609050709050609050709050609050709050609050709050609050709050609050709050609050702-1-102-1-102-1-102-1-102-1-102-1-102-1-102-1-102-1-102-1-102-1-102-1-109050609050709050609050709050609050709050609050709050609050709050609050709050609050709050609050702-1-101040102-1-101040102-1-102-1-1
02-1-109060609060709060609060709060609060709060609060709060609060709060609060709060609060709060609060709060609060709060609060709060609060709060609060709060609060709060609060702-1-102-1-102-1-102-1-102-1-102-1-102-1-102-1-102-1-102-1-102-1-102-1-109060609060709060609060709060609060709060609060709060609060709060609060709060609060709060609060702-1-101040102-1-101040102-1-102-1-1
02-1-109050609050709050609050709050609050709050609050709050609050709050609050709050609050709050609050709050609050709050609050709050609050709050609050709050609050709050609050709050809050902-1-102-1-102-1-102-1-102-1-102-1-102-1-102-1-102-1-109050509050609050709050609050709050609050709050609050709050609050709050609050709050609050709050609050709050801040102-1-101040102-1-102-1-1
02-1-109060609060709060609060709060609060709060609060709060609060709060609060709060609060709060609060709060609060709060609060709060609060709060609060709060609060709060609060709060809060902-1-102-1-102-1-102-1-102-1-102-1-102-1-102-1-102-1-109060509060609060709060609060709060609060709060609060709060609060709060609060709060609060709060609060709060801040102-1-101040102-1-102-1-1
02-1-109050609050702-1-102-1-102-1-102-1-102-1-102-1-102-1-102-1-102-1-102-1-102-1-102-1-102-1-102-1-102-1-102-1-102-1-102-1-102-1-102-1-102-1-102-1-102-1-102-1-102-1-102-1-102-1-102-1-102-1-102-1-102-1-102-1-102-1-102-1-102-1-102-1-102-1-102-1-102-1-102-1-102-1-102-1-102-1-102-1-102-1-102-1-102-1-102-1-102-1-102-1-102-1-102-1-102-1-102-1-102-1-101040102-1-101040102-1-102-1-1
02-1-109060609060702-1-102-1-102-1-102-1-102-1-102-1-102-1-102-1-102-1-102-1-102-1-102-1-102-1-102-1-102-1-102-1-102-1-102-1-102-1-102-1-102-1-102-1-102-1-102-1-102-1-102-1-102-1-102-1-102-1-102-1-102-1-102-1-102-1-102-1-102-1-102-1-102-1-102-1-102-1-102-1-102-1-102-1-102-1-102-1-102-1-102-1-102-1-102-1-102-1-102-1-102-1-102-1-102-1-102-1-102-1-101040102-1-101040102-1-102-1-1
02-1-109050609050702-1-102-1-102-1-102-1-102-1-102-1-102-1-102-1-102-1-102-1-102-1-102-1-102-1-102-1-102-1-102-1-102-1-102-1-102-1-102-1-102-1-102-1-102-1-102-1-102-1-102-1-102-1-102-1-102-1-102-1-102-1-102-1-102-1-102-1-102-1-102-1-102-1-102-1-102-1-102-1-102-1-102-1-102-1-102-1-102-1-102-1-102-1-102-1-102-1-102-1-102-1-102-1-102-1-102-1-102-1-101040102-1-101040102-1-102-1-1
02-1-109060609060702-1-102-1-102-1-102-1-102-1-102-1-102-1-102-1-102-1-102-1-102-1-102-1-102-1-102-1-102-1-102-1-102-1-102-1-102-1-102-1-102-1-102-1-102-1-102-1-102-1-102-1-102-1-102-1-102-1-102-1-102-1-102-1-102-1-102-1-102-1-102-1-102-1-102-1-102-1-102-1-102-1-102-1-102-1-102-1-102-1-102-1-102-1-102-1-102-1-102-1-102-1-102-1-102-1-102-1-102-1-101040102-1-101040102-1-102-1-1
02-1-109050609050702-1-102-1-102-1-102-1-102-1-102-1-102-1-102-1-102-1-102-1-102-1-102-1-102-1-102-1-102-1-102-1-102-1-102-1-102-1-102-1-102-1-102-1-102-1-102-1-102-1-102-1-102-1-102-1-102-1-102-1-102-1-102-1-102-1-102-1-102-1-102-1-102-1-102-1-102-1-102-1-102-1-102-1-102-1-102-1-102-1-102-1-102-1-102-1-102-1-102-1-102-1-102-1-102-1-102-1-102-1-101040102-1-101040102-1-102-1-1
02-1-109060609060702-1-102-1-102-1-102-1-102-1-102-1-102-1-102-1-102-1-102-1-102-1-102-1-102-1-102-1-102-1-102-1-102-1-102-1-102-1-102-1-102-1-102-1-102-1-102-1-102-1-102-1-102-1-102-1-102-1-102-1-102-1-102-1-102-1-102-1-102-1-102-1-102-1-102-1-102-1-102-1-102-1-102-1-102-1-102-1-102-1-102-1-102-1-102-1-102-1-102-1-102-1-102-1-102-1-102-1-102-1-101040102-1-101040102-1-102-1-1
02-1-109050609050702-1-102-1-102-1-102-1-102-1-102-1-102-1-102-1-102-1-102-1-102-1-102-1-102-1-102-1-102-1-102-1-102-1-102-1-102-1-102-1-102-1-102-1-102-1-102-1-102-1-102-1-102-1-102-1-102-1-102-1-102-1-102-1-102-1-102-1-102-1-102-1-102-1-102-1-102-1-102-1-102-1-102-1-102-1-102-1-102-1-102-1-102-1-102-1-102-1-102-1-102-1-102-1-102-1-102-1-102-1-101040102-1-101040102-1-102-1-1
02-1-109060609060702-1-102-1-102-1-102-1-102-1-102-1-102-1-102-1-102-1-102-1-102-1-102-1-102-1-102-1-102-1-102-1-102-1-102-1-102-1-102-1-102-1-102-1-102-1-102-1-102-1-102-1-102-1-102-1-102-1-102-1-102-1-102-1-102-1-102-1-102-1-102-1-102-1-102-1-102-1-102-1-102-1-102-1-102-1-102-1-102-1-102-1-102-1-102-1-102-1-102-1-102-1-102-1-102-1-102-1-102-1-101040102-1-101040102-1-102-1-1
02-1-109050609050702-1-102-1-102-1-102-1-102-1-102-1-102-1-102-1-102-1-102-1-102-1-109060402-1-102-1-102-1-102-1-102-1-102-1-102-1-102-1-102-1-102-1-102-1-102-1-102-1-102-1-102-1-102-1-102-1-102-1-102-1-102-1-102-1-102-1-102-1-102-1-102-1-102-1-102-1-102-1-102-1-102-1-102-1-102-1-102-1-102-1-102-1-102-1-102-1-102-1-102-1-102-1-102-1-102-1-102-1-101040102-1-101040102-1-102-1-1
02-1-109060609060702-1-102-1-102-1-102-1-102-1-102-1-102-1-102-1-102-1-102-1-102-1-102-1-102-1-102-1-102-1-102-1-102-1-102-1-102-1-102-1-102-1-102-1-102-1-102-1-102-1-102-1-102-1-102-1-102-1-102-1-102-1-102-1-102-1-102-1-102-1-102-1-102-1-102-1-102-1-102-1-102-1-102-1-102-1-102-1-102-1-102-1-102-1-102-1-102-1-102-1-102-1-102-1-102-1-102-1-102-1-101040102-1-101040102-1-102-1-1
02-1-109050609050702-1-102-1-102-1-102-1-102-1-102-1-102-1-102-1-102-1-102-1-102-1-102-1-102-1-102-1-102-1-102-1-102-1-102-1-102-1-102-1-102-1-102-1-102-1-102-1-102-1-102-1-102-1-102-1-102-1-102-1-102-1-102-1-102-1-102-1-102-1-102-1-102-1-102-1-102-1-102-1-102-1-102-1-102-1-102-1-102-1-102-1-102-1-102-1-102-1-102-1-102-1-102-1-102-1-102-1-102-1-101040102-1-101040102-1-102-1-1
02-1-109060609060702-1-102-1-102-1-102-1-102-1-102-1-102-1-102-1-102-1-102-1-102-1-102-1-102-1-102-1-102-1-102-1-102-1-102-1-102-1-102-1-102-1-102-1-102-1-102-1-102-1-102-1-102-1-102-1-102-1-102-1-102-1-102-1-102-1-102-1-102-1-102-1-102-1-102-1-102-1-102-1-102-1-102-1-102-1-102-1-102-1-102-1-102-1-102-1-102-1-102-1-102-1-102-1-102-1-102-1-102-1-101040102-1-101040102-1-102-1-1
02-1-109050609050702-1-102-1-102-1-102-1-102-1-102-1-102-1-102-1-102-1-102-1-102-1-102-1-102-1-102-1-102-1-102-1-102-1-102-1-102-1-102-1-102-1-102-1-102-1-102-1-102-1-102-1-102-1-102-1-102-1-102-1-102-1-102-1-102-1-102-1-102-1-102-1-102-1-102-1-102-1-102-1-102-1-102-1-102-1-102-1-102-1-102-1-102-1-102-1-102-1-102-1-102-1-102-1-102-1-102-1-102-1-101040102-1-101040102-1-102-1-1
02-1-109060609060702-1-102-1-102-1-102-1-102-1-102-1-102-1-102-1-102-1-102-1-102-1-102-1-102-1-102-1-102-1-102-1-102-1-102-1-102-1-102-1-102-1-102-1-102-1-102-1-102-1-102-1-102-1-102-1-102-1-102-1-102-1-102-1-102-1-102-1-102-1-102-1-102-1-102-1-102-1-102-1-102-1-102-1-102-1-102-1-102-1-102-1-102-1-102-1-102-1-102-1-102-1-102-1-102-1-102-1-102-1-101040102-1-101040102-1-102-1-1
02-1-109050609050702-1-102-1-102-1-102-1-102-1-102-1-102-1-102-1-102-1-102-1-102-1-102-1-102-1-102-1-102-1-102-1-102-1-102-1-102-1-102-1-102-1-102-1-102-1-102-1-102-1-102-1-102-1-102-1-102-1-102-1-102-1-102-1-102-1-102-1-102-1-102-1-102-1-102-1-102-1-102-1-102-1-102-1-102-1-102-1-102-1-102-1-102-1-102-1-102-1-102-1-102-1-102-1-102-1-102-1-102-1-101040102-1-101040102-1-102-1-1
02-1-109060609060702-1-102-1-102-1-102-1-102-1-102-1-102-1-102-1-102-1-102-1-102-1-102-1-102-1-102-1-102-1-102-1-102-1-102-1-102-1-102-1-102-1-102-1-102-1-102-1-102-1-102-1-102-1-102-1-102-1-102-1-102-1-102-1-102-1-102-1-102-1-102-1-102-1-102-1-102-1-102-1-102-1-102-1-102-1-102-1-102-1-102-1-102-1-102-1-102-1-102-1-102-1-102-1-102-1-102-1-102-1-101040102-1-101040102-1-102-1-1
09050709050809050709050809050902-1-102-1-102-1-102-1-102-1-102-1-102-1-102-1-102-1-102-1-102-1-102-1-102-1-102-1-102-1-102-1-102-1-102-1-102-1-102-1-102-1-102-1-102-1-102-1-102-1-102-1-102-1-102-1-102-1-102-1-102-1-102-1-102-1-102-1-102-1-102-1-102-1-102-1-102-1-102-1-102-1-102-1-102-1-102-1-102-1-102-1-102-1-102-1-102-1-102-1-102-1-102-1-102-1-1010501010502010501010502010502
09060709060809060709060809060902-1-102-1-102-1-102-1-102-1-102-1-102-1-102-1-102-1-102-1-102-1-102-1-102-1-102-1-102-1-102-1-102-1-102-1-102-1-102-1-102-1-102-1-102-1-102-1-102-1-102-1-102-1-102-1-102-1-102-1-102-1-102-1-102-1-102-1-102-1-102-1-102-1-102-1-102-1-102-1-102-1-102-1-102-1-102-1-102-1-102-1-102-1-102-1-102-1-102-1-102-1-102-1-102-1-1010601010602010602010602010602
02-1-102-1-102-1-102-1-102-1-102-1-102-1-102-1-102-1-102-1-102-1-102-1-102-1-102-1-102-1-102-1-102-1-102-1-102-1-102-1-102-1-102-1-102-1-102-1-102-1-102-1-102-1-102-1-102-1-102-1-102-1-102-1-102-1-102-1-102-1-102-1-102-1-102-1-102-1-102-1-102-1-102-1-102-1-102-1-102-1-102-1-102-1-102-1-102-1-102-1-102-1-102-1-102-1-102-1-102-1-102-1-102-1-102-1-102-1-102-1-102-1-102-1-102-1-1
02-1-102-1-102-1-102-1-102-1-102-1-102-1-102-1-102-1-102-1-102-1-102-1-102-1-102-1-102-1-102-1-102-1-102-1-102-1-102-1-102-1-102-1-102-1-102-1-102-1-102-1-102-1-102-1-102-1-102-1-102-1-102-1-102-1-102-1-102-1-102-1-102-1-102-1-102-1-102-1-102-1-102-1-102-1-102-1-102-1-102-1-102-1-102-1-102-1-102-1-102-1-102-1-102-1-102-1-102-1-102-1-102-1-102-1-102-1-102-1-102-1-102-1-102-1-1
02-1-102-1-102-1-102-1-102-1-102-1-102-1-102-1-102-1-102-1-102-1-102-1-102-1-102-1-102-1-102-1-102-1-102-1-102-1-102-1-102-1-102-1-102-1-102-1-102-1-102-1-102-1-102-1-102-1-102-1-102-1-102-1-102-1-102-1-102-1-102-1-102-1-102-1-102-1-102-1-102-1-102-1-102-1-102-1-102-1-102-1-102-1-102-1-102-1-102-1-102-1-102-1-102-1-102-1-102-1-102-1-102-1-102-1-102-1-102-1-102-1-102-1-102-1-1
02-1-102-1-102-1-102-1-102-1-102-1-102-1-102-1-102-1-102-1-102-1-102-1-102-1-102-1-102-1-102-1-102-1-102-1-102-1-102-1-102-1-102-1-102-1-102-1-102-1-102-1-102-1-102-1-102-1-102-1-102-1-102-1-102-1-102-1-102-1-102-1-102-1-102-1-102-1-102-1-102-1-102-1-102-1-102-1-102-1-102-1-102-1-102-1-102-1-102-1-102-1-102-1-102-1-102-1-102-1-102-1-102-1-102-1-102-1-102-1-102-1-102-1-102-1-1
02-1-102-1-102-1-102-1-102-1-102-1-102-1-102-1-102-1-102-1-102-1-102-1-102-1-102-1-102-1-102-1-102-1-102-1-102-1-102-1-102-1-102-1-102-1-102-1-102-1-102-1-102-1-102-1-102-1-102-1-102-1-102-1-102-1-102-1-102-1-102-1-102-1-102-1-102-1-102-1-102-1-102-1-102-1-102-1-102-1-102-1-102-1-102-1-102-1-102-1-102-1-102-1-102-1-102-1-102-1-102-1-102-1-102-1-102-1-102-1-102-1-102-1-102-1-1
02-1-102-1-102-1-102-1-102-1-102-1-102-1-102-1-102-1-102-1-102-1-102-1-102-1-102-1-102-1-102-1-102-1-102-1-102-1-102-1-102-1-102-1-102-1-102-1-102-1-102-1-102-1-102-1-102-1-102-1-102-1-102-1-102-1-102-1-102-1-102-1-102-1-102-1-102-1-102-1-102-1-102-1-102-1-102-1-102-1-102-1-102-1-102-1-102-1-102-1-102-1-102-1-102-1-102-1-102-1-102-1-102-1-102-1-102-1-102-1-102-1-102-1-102-1-1
02-1-102-1-102-1-102-1-102-1-102-1-102-1-102-1-102-1-102-1-102-1-102-1-102-1-102-1-102-1-102-1-102-1-102-1-102-1-102-1-102-1-102-1-102-1-102-1-102-1-102-1-102-1-102-1-102-1-102-1-102-1-102-1-102-1-102-1-102-1-102-1-102-1-102-1-102-1-102-1-102-1-102-1-102-1-102-1-102-1-102-1-102-1-102-1-102-1-102-1-102-1-102-1-102-1-102-1-102-1-102-1-102-1-102-1-102-1-102-1-102-1-102-1-102-1-1
02-1-102-1-102-1-102-1-102-1-102-1-102-1-102-1-102-1-102-1-102-1-102-1-102-1-102-1-102-1-102-1-102-1-102-1-102-1-102-1-102-1-102-1-102-1-102-1-102-1-102-1-102-1-102-1-102-1-102-1-102-1-102-1-102-1-102-1-102-1-102-1-102-1-102-1-102-1-102-1-102-1-102-1-102-1-102-1-102-1-102-1-102-1-102-1-102-1-102-1-102-1-102-1-102-1-102-1-102-1-102-1-102-1-102-1-102-1-102-1-102-1-102-1-102-1-1
02-1-102-1-102-1-102-1-102-1-102-1-102-1-102-1-102-1-102-1-102-1-102-1-102-1-102-1-102-1-102-1-102-1-102-1-102-1-102-1-102-1-102-1-102-1-102-1-102-1-102-1-102-1-102-1-102-1-102-1-102-1-102-1-102-1-102-1-102-1-102-1-102-1-102-1-102-1-102-1-102-1-102-1-102-1-102-1-102-1-102-1-102-1-102-1-102-1-102-1-102-1-102-1-102-1-102-1-102-1-102-1-102-1-102-1-102-1-102-1-102-1-102-1-102-1-1
02-1-102-1-102-1-102-1-102-1-102-1-102-1-102-1-102-1-102-1-102-1-102-1-102-1-102-1-102-1-102-1-102-1-102-1-102-1-102-1-102-1-102-1-102-1-102-1-102-1-102-1-102-1-102-1-102-1-102-1-102-1-102-1-102-1-102-1-102-1-102-1-102-1-102-1-102-1-102-1-102-1-102-1-102-1-102-1-102-1-102-1-102-1-102-1-102-1-102-1-102-1-102-1-102-1-102-1-102-1-102-1-102-1-102-1-102-1-102-1-102-1-102-1-102-1-1
02-1-102-1-102-1-102-1-102-1-102-1-102-1-102-1-102-1-102-1-102-1-102-1-102-1-102-1-102-1-102-1-102-1-102-1-102-1-102-1-102-1-102-1-102-1-102-1-102-1-102-1-102-1-102-1-102-1-102-1-102-1-102-1-102-1-102-1-102-1-102-1-102-1-102-1-102-1-102-1-102-1-102-1-102-1-102-1-102-1-102-1-102-1-102-1-102-1-102-1-102-1-102-1-102-1-102-1-102-1-102-1-102-1-102-1-102-1-102-1-102-1-102-1-102-1-1
02-1-102-1-102-1-102-1-102-1-102-1-102-1-102-1-102-1-102-1-102-1-102-1-102-1-102-1-102-1-102-1-102-1-102-1-102-1-102-1-102-1-102-1-102-1-102-1-102-1-102-1-102-1-102-1-102-1-102-1-102-1-102-1-102-1-102-1-102-1-102-1-102-1-102-1-102-1-102-1-102-1-102-1-102-1-102-1-102-1-102-1-102-1-102-1-102-1-102-1-102-1-102-1-102-1-102-1-102-1-102-1-102-1-102-1-102-1-102-1-102-1-102-1-102-1-1
02-1-102-1-102-1-102-1-102-1-102-1-102-1-102-1-102-1-102-1-102-1-102-1-102-1-102-1-102-1-102-1-102-1-102-1-102-1-102-1-102-1-102-1-102-1-102-1-102-1-102-1-102-1-102-1-102-1-102-1-102-1-102-1-102-1-102-1-102-1-102-1-102-1-102-1-102-1-102-1-102-1-102-1-102-1-102-1-102-1-102-1-102-1-102-1-102-1-102-1-102-1-102-1-102-1-102-1-102-1-102-1-102-1-102-1-102-1-102-1-102-1-102-1-102-1-1
02-1-102-1-102-1-102-1-102-1-102-1-102-1-102-1-102-1-102-1-102-1-102-1-102-1-102-1-102-1-102-1-102-1-102-1-102-1-102-1-102-1-102-1-102-1-102-1-102-1-102-1-102-1-102-1-102-1-102-1-102-1-102-1-102-1-102-1-102-1-102-1-102-1-102-1-102-1-102-1-102-1-102-1-102-1-102-1-102-1-102-1-102-1-102-1-102-1-102-1-102-1-102-1-102-1-102-1-102-1-102-1-102-1-102-1-102-1-102-1-102-1-102-1-102-1-1
02-1-102-1-102-1-102-1-102-1-102-1-102-1-102-1-102-1-102-1-102-1-102-1-102-1-102-1-102-1-102-1-102-1-102-1-102-1-102-1-102-1-102-1-102-1-102-1-102-1-102-1-102-1-102-1-102-1-102-1-102-1-102-1-102-1-102-1-102-1-102-1-102-1-102-1-102-1-102-1-102-1-102-1-102-1-102-1-102-1-102-1-102-1-102-1-102-1-102-1-102-1-102-1-102-1-102-1-102-1-102-1-102-1-102-1-102-1-102-1-102-1-102-1-102-1-1
02-1-102-1-102-1-102-1-102-1-102-1-102-1-102-1-102-1-102-1-102-1-102-1-102-1-102-1-102-1-102-1-102-1-102-1-102-1-102-1-102-1-102-1-102-1-102-1-102-1-102-1-102-1-102-1-102-1-102-1-102-1-102-1-102-1-102-1-102-1-102-1-102-1-102-1-102-1-102-1-102-1-102-1-102-1-102-1-102-1-102-1-102-1-102-1-102-1-102-1-102-1-102-1-102-1-102-1-102-1-102-1-102-1-102-1-102-1-102-1-102-1-102-1-102-1-1
02-1-102-1-102-1-102-1-102-1-102-1-102-1-102-1-102-1-102-1-102-1-102-1-102-1-102-1-102-1-102-1-102-1-102-1-102-1-102-1-102-1-102-1-102-1-102-1-102-1-102-1-102-1-102-1-102-1-102-1-102-1-102-1-102-1-102-1-102-1-102-1-102-1-102-1-102-1-102-1-102-1-102-1-102-1-102-1-102-1-102-1-102-1-102-1-102-1-102-1-102-1-102-1-102-1-102-1-102-1-102-1-102-1-102-1-102-1-102-1-102-1-102-1-102-1-1
02-1-102-1-102-1-102-1-102-1-102-1-102-1-102-1-102-1-102-1-102-1-102-1-102-1-102-1-102-1-102-1-102-1-102-1-102-1-102-1-102-1-102-1-102-1-102-1-102-1-102-1-102-1-102-1-102-1-102-1-102-1-102-1-102-1-102-1-102-1-102-1-102-1-102-1-102-1-102-1-102-1-102-1-102-1-102-1-102-1-102-1-102-1-102-1-102-1-102-1-102-1-102-1-102-1-102-1-102-1-102-1-102-1-102-1-102-1-102-1-102-1-102-1-102-1-1
02-1-102-1-102-1-102-1-102-1-102-1-102-1-102-1-102-1-102-1-102-1-102-1-102-1-102-1-102-1-102-1-102-1-102-1-102-1-102-1-102-1-102-1-102-1-102-1-102-1-102-1-102-1-102-1-102-1-102-1-102-1-102-1-102-1-102-1-102-1-102-1-102-1-102-1-102-1-102-1-102-1-102-1-102-1-102-1-102-1-102-1-102-1-102-1-102-1-102-1-102-1-102-1-102-1-102-1-102-1-102-1-102-1-102-1-102-1-102-1-102-1-102-1-102-1-1
02-1-102-1-102-1-102-1-102-1-102-1-102-1-102-1-102-1-102-1-102-1-102-1-102-1-102-1-102-1-102-1-102-1-102-1-102-1-102-1-102-1-102-1-102-1-102-1-102-1-102-1-102-1-102-1-102-1-102-1-102-1-102-1-102-1-102-1-102-1-102-1-102-1-102-1-102-1-102-1-102-1-102-1-102-1-102-1-102-1-102-1-102-1-102-1-102-1-102-1-102-1-102-1-102-1-102-1-102-1-102-1-102-1-102-1-102-1-102-1-102-1-102-1-102-1-1
02-1-102-1-102-1-102-1-102-1-102-1-102-1-102-1-102-1-102-1-102-1-102-1-102-1-102-1-102-1-102-1-102-1-102-1-102-1-102-1-102-1-102-1-102-1-102-1-102-1-102-1-102-1-102-1-102-1-102-1-102-1-102-1-102-1-102-1-102-1-102-1-102-1-102-1-102-1-102-1-102-1-102-1-102-1-102-1-102-1-102-1-102-1-102-1-102-1-102-1-102-1-102-1-102-1-102-1-102-1-102-1-102-1-102-1-102-1-102-1-102-1-102-1-102-1-1
02-1-102-1-102-1-102-1-102-1-102-1-102-1-102-1-102-1-102-1-102-1-102-1-102-1-102-1-102-1-102-1-102-1-102-1-102-1-102-1-102-1-102-1-102-1-102-1-102-1-102-1-102-1-102-1-102-1-102-1-102-1-102-1-102-1-102-1-102-1-102-1-102-1-102-1-102-1-102-1-102-1-102-1-102-1-102-1-102-1-102-1-102-1-102-1-102-1-102-1-102-1-102-1-102-1-102-1-102-1-102-1-102-1-102-1-102-1-102-1-102-1-102-1-102-1-1
02-1-102-1-102-1-102-1-102-1-102-1-102-1-102-1-102-1-102-1-102-1-102-1-102-1-102-1-102-1-102-1-102-1-102-1-102-1-102-1-102-1-102-1-102-1-102-1-102-1-102-1-102-1-102-1-102-1-102-1-102-1-102-1-102-1-102-1-102-1-102-1-102-1-102-1-102-1-102-1-102-1-102-1-102-1-102-1-102-1-102-1-102-1-102-1-102-1-102-1-102-1-102-1-102-1-102-1-102-1-102-1-102-1-102-1-102-1-102-1-102-1-102-1-102-1-1
02-1-102-1-102-1-102-1-102-1-102-1-102-1-102-1-102-1-102-1-102-1-102-1-102-1-102-1-102-1-102-1-102-1-102-1-102-1-102-1-102-1-102-1-102-1-102-1-102-1-102-1-102-1-102-1-102-1-102-1-102-1-102-1-102-1-102-1-102-1-102-1-102-1-102-1-102-1-102-1-102-1-102-1-102-1-102-1-102-1-102-1-102-1-102-1-102-1-102-1-102-1-102-1-102-1-102-1-102-1-102-1-102-1-102-1-102-1-102-1-102-1-102-1-102-1-1
02-1-102-1-102-1-102-1-102-1-102-1-102-1-102-1-102-1-102-1-102-1-102-1-102-1-102-1-102-1-102-1-102-1-102-1-102-1-102-1-102-1-102-1-102-1-102-1-102-1-102-1-102-1-102-1-102-1-102-1-102-1-102-1-102-1-102-1-102-1-102-1-102-1-102-1-102-1-102-1-102-1-102-1-102-1-102-1-102-1-102-1-102-1-102-1-102-1-102-1-102-1-102-1-102-1-102-1-102-1-102-1-102-1-102-1-102-1-102-1-102-1-102-1-102-1-1
02-1-102-1-102-1-102-1-102-1-102-1-102-1-102-1-102-1-102-1-102-1-102-1-102-1-102-1-102-1-102-1-102-1-102-1-102-1-102-1-102-1-102-1-102-1-102-1-102-1-102-1-102-1-102-1-102-1-102-1-102-1-102-1-102-1-102-1-102-1-102-1-102-1-102-1-102-1-102-1-102-1-102-1-102-1-102-1-102-1-102-1-102-1-102-1-102-1-102-1-102-1-102-1-102-1-102-1-102-1-102-1-102-1-102-1-102-1-102-1-102-1-102-1-102-1-1
02-1-102-1-102-1-102-1-102-1-102-1-102-1-102-1-102-1-102-1-102-1-102-1-102-1-102-1-102-1-102-1-102-1-102-1-102-1-102-1-102-1-102-1-102-1-102-1-102-1-102-1-102-1-102-1-102-1-102-1-102-1-102-1-102-1-102-1-102-1-102-1-102-1-102-1-102-1-102-1-102-1-102-1-102-1-102-1-102-1-102-1-102-1-102-1-102-1-102-1-102-1-102-1-102-1-102-1-102-1-102-1-102-1-102-1-102-1-102-1-102-1-102-1-102-1-1
