40
40
02031010020310100203101002031010020310100203101002031010020310100203101002031010020310100203101002031010020310100203101002031010020310100203101002031010030010040704201007041015070410140704101407041013070140150203101002031010020310100203101002031010020310100203101002031010020310100203101002031010020310100203101002031010
02031010020310100203101002031010020310100203101002031010020310100203101002031010020310100203101002031010020310100203101002031010020310100203101002031010030010040704101007041014070410140704101407042013070140150203101002031010020310100203101002031010020310100203101002031010020310100203101002031010020310100203101002031010
02031010020310100203101002031010020310100203101002031010020310100203101002031010020310100203101002031010020310100203101002031010020310100203101002031010030010040704201007041015070410140704101507041013070140150203101002031010020310100203101002031010020310100203101002031010020310100203101002031010020310100203101002031010
02031010020310100203101002031010020310100203101002031010020310100203101002031010020310100203101002031010020310100203101002031010020310100203101002031010030010040704101007041014070410140704101407042013070130150203101002031010020310100203101002031010020310100203101002031010020310100203101002031010020310100203101002031010
02031010020310100203101002031010020310100203101002031010020310100203101002031010020310100203101002031010020310100203101002031010020310100203101002031010030010040704201007041014070410150704101407041013070140150203101002031010020310100203101002031010020310100203101002031010020310100203101002031010020310100203101002031010
02031010020310100203101002031010020310100203101002031010020310100203101002031010020310100203101002031010020310100203101002031010020310100203101002031010030010040704101007041014070410140704101407042013070140150203101002031010020310100203101007034019070340200203101002031010020310100203101002031010020310100203101002031010
02031010020310100203101002031010020310100203101002031010030000020300000303000003030000030300000303000003030000030300000303000003030000030300000303000003030020040704201007040014070400140704001407041013070160140701601507014015070140150701601507035019070350200701401507016014070140150701401507016015070140150701401507014015
02031010020310100203101002031010020310100203101002031010030010040701301507014014070130150701601507014014070140140005605800056059000560600005606100056062030110020704101007040014070410150704001407041013070140140701601507014014070140140701601507036019070360200701301507014014070140140701301507014014070160150701401407016015
02031010020310100203101002031010020310100203101002031010030010040701301507013015070150140401409304014093070140150005705800057059000570600005706100057062030120020704201007040014070400140704001407041013070130150701401507013015070130150701301507013015070140150701401507013015070130150701501407013015070140150701301507013015
02031010020310100203101002031010020310100203101002031010030010040701301504015003040150030401500304015003040150030005805800058059000580600005806100058062070400120704201207040014070400140704001407042011070400110704001107040011070400110404206704042067040420680404206904042070040420710704001107040013070340190703402007034019
02031010020310100203101002031010020310100203101002031010030010040701301504015013040150130401501304015013040150130005905800059059000590600005906100059062070400140704001407040014070410150704001407040014070400140704001404043064040430650404306604043067040430680404306904043070040430710404307207042013070340190703402007034019
02031010020310100203101002031010020310100203101002031010030010040701301504015023040150230401502304015023040150230006005800060059000600600006006100060062070400150704001507041015070410150704001507041015070410150704001504044064040440650404406604044067040440680404406904044070040440710404407207042013070340190703402007034019
02031010020310100203101002031010020310100203101002031010030010040701401404015033040150330401504304015043040150330006105800061059000610600006106100061062070400150704101507041015070410150704101507041015070410150704101504045064040450650404506604045067040450680404506904045070040450710404507207042013070340190703402007034019
02031010020310100203101002031010020310100203101002031010030010040701301507041010040150530401505304015053040150530006205800062059000620600006206100062062070400150704101507041015070410150704101507041015070410150704101504046064040460650404606607041015070410150704101507041015070410150704101507042013070340190703402007034019
02031010020310100203101002031010020310100203101002031010030010040701301507042010040150630401506304015063040150630006305800063059070410150006306100063062070400150704101507041015070410150704101507041015070410150704101507041014040470650404706604047067040470680404706904047070040470710704101407042013070340190703402007034019
02031010020310100203101002031010020310100203101002031010030010040701501407041010070400150704101507040015070400150704001507040015070410150704101507040015070410150704101507041015070410150704101507041015070410140704101407041014040480650404806604048067040480680404806904048070040480710704101407042013070340190703402007034019
02031010020310100203101002031010020310100203101002031010030010040701301507041010070400150704001507041015070400150704101407041015070400150704001507041014070410140704101507041015070410150704101507041015070410150704101407041014070410140704101407041015070410140704101407041014070410140704101407042013070340190703402007034019
02031010020310100203101002031010020310100203101002031010030110050301100603011007070410140704101407041014070410140704101507041014070410140704101507041014070410140704101407041015000010600000106100001062070410150704101400001065000010660000106707041014070410140000107000001071000010720704101407042013070340190703402007034019
03000000030000000300000003000000030000000300000003000000030020040301200603012006070410140704101407041015070410150704101507041014070410150704101407041014070410150704101400002059000020600000206100002062000020630000206400002065000020660000206700002068000020690000207000002071000020720000207307042013070350190703502007035019
07040012070400110704001207040012070400120704001107040012070400120704001107042012070410150704101507041014070410140704101407041015070410140704101407041014070410140704101500003059000030600000306100003062000030630000306400003065000030660000306700003068000030690000307000003071000030720000307303011005030110060301100707036019
07041015070400150704101507041014070410140704001507041014070400150704101507041015070410140704101407041014070410150704101400004008000040090000401000004011070410140704101500004059000040600000406100004062000040630000406400004065000040660000406700004068000040690000407000004071000040720000407307042011030120060704001207040012
07041014070410140704101407040015070410140704101407041015070410150704101407041015070410140704101507041014070410140704101500005008000050090000501000005011070410140704101400005059000050600000506100005062000050630000506400005065000050660000506700005068000050690000507000005071000050720000507307040015070400150704001507040015
07041014070410150704101407041014070410140704101407041014070410140704001507041015070410140704101507041015070410150704101500008008000080090000801000008011070410150704101500006059000060600000606100006062000060630000606400006065000060660000606700006068000060690000607000006071000060720000607307040015070400150704001507040015
07040015070400150704101407040015070400150704101507040015070400150704101407041014070410140704001507040015070400150300900400009008000090090000901000009011070400150704001500007059000070600000706100007062000070630000706400007065000070660000706700007068000070690000707000007071000070720000707307040015070400150704001507040015
07043011070430110704301107043011070430110704301107043011070430110704301107043011070410120704001507040015070400150704101107043012070430120704301207043012070430120704101200008059000080600000806100008062000080630000806400008065000080660000806700008068000080690000807000008071000080720000807307041011070430110702702407027025
02025001020250020202500102025002020250010202500202025001020250020202500102025002070420100704001507040015070400150704201302000000020000000200000002000000020000000704101000009059000090600000906100009062000090630000906400009065000090660000906700009068000090690000907000009071000090720000907307041013070280230702802407028025
02026001020260020202600102026002020260010202600202026001020260020202600102026002070410100704001507040015070400150704201302000000020000000200000002000000020000000704101000010059000100600001006100010062000100630001006400010065000100660001006700010068000100690001007000010071000100720001007307041013070280230702802407028025
07022020070220210702202202000000020000000200000002000000070370230703702403011005030110060301100707040015070400150704201302000000020000000200000002000000020000000704101000011059000110630001106300011063000110630001106400011065000110660001106700011068000110690001107000011071000110720001107307041013070290230702902407029025
07023020070230210702302207028020070280210200000002000000070380230703802402000000030120060704301107043011070430110704301302000000020000000200000002000000020000000704101000013059000130600001306100013062000130630001306400013065000130660001306700013068000130690001307000013070000130720001307307041013070280230702802407028025
07024020070240210702901907029020070290210702902202000000020000000200700702000000020000000200000002000000020000000200000002000000020000000200000002000000020000000704101000014059000140600001406100014062000140630001406400014065000140660001406700014068000140690001407000014071000140720001407307041013070290230702902407029025
07026020070260210200000007032020070320210200000002000000020000000200700702000000020000000200000002000000020000000200000002000000020000000200000002000000020000000704101000015059000150600001506100015062000150630301100400015065000150660001506700015068000150690002105500021056000210570001507307042013070280230702802407028025
02000000020000000200000002000000020000000200000002000000020000000200700702000000020000000200000002000000020000000200000002000000020000000200000002000000020000000704201007040015070400150704001507040015070400150301200407040015070400150704001507040015070400150002205500022056000220570704001507042013070290230702902407029025
07037023070370240703702307037024070370230703702407037023070370240200700702000000020190180201902002019020020190200201902102000000020070070200000002000000020000000704301007043011070430110704301107043011070430110704301107043011070430110704301107043011070430110002305500023056000230570704301107043013070280230702802407028025
07038023070380240703802307038024070380230703802407038023070380240200700702000000020200180202002002020020020200200202002102000000020070070200000002000000020000000200000002000000020000000200000002000000020000000200000002012009020120110201201102012011020120120200000002000000020000000200000002000000070290230702902407029025
07037023070370240703702307037024070370230703702407037023070370240200700702000000020200180202002002020020020200200202002102000000020070070201600102016002020160010201600202016001020160020201600102016002020160010201600202013009020130110201301102013011020130120200000002000000020000000200000002000000070280230702802407028025
07038023070380240703802307038024070380230703802407038023070380240200700702000000020200180202002002020020020200200202002102000000020070070201700102017002020170010201700202017001020170020201700202017002020170010201700202013009020130110201301102013011020130120702802307027024070270250200000007027024070290230702902407029025
07037023070370240703702307037024070370230703702407037023070370240200700702000000020200180202002002020020020200200202002102000000020070070201600102016002020160010201600202016001020160020201600102016002020160010201600202013009020130110201301102013011020130120702802307028024070280250702802307028024070280230702802407028025
07038023070380240703802307038024070380230703802407038023070380240200700702000000020200180202002002020020020200200202002102000000020070070201700102017002020170020201700202017001020170020201700102017002020170010201700202013009020130110201301102013011020130120702902307029024070290250702902307029024070290230702902407029025
07037023070370240703702307037024070370230703702407037023070370240200700702000000020200180202002002020020020200200202002102000000020070070201600102016002020160010201600202016001020160020201600102016002020160010201600202013009020130110201301102013011020130120702802307028024070280250702802307028024070280230702802407028025
07038023070380240703802307038024070380230703802407038023070380240200800702000000020200180202002002020020020200200202002102000000020080070201700102017002020170010201700202017001020170020201700102017002020170010201700202013009020130110201301102013011020130120702902307029024070290250702902307029024070290230702902407029025
