63
51
00-1-100-1-100-1-100-1-100-1-100-1-100-1-100-1-102-1-102-1-102-1-102-1-102-1-102-1-102-1-102-1-102-1-102-1-102-1-102-1-102-1-102-1-102-1-102-1-102-1-102-1-102-1-102-1-102-1-102-1-102-1-102-1-102-1-102-1-102-1-102-1-102-1-102-1-102-1-102-1-102-1-102-1-102-1-102-1-102-1-102-1-102-1-102-1-102-1-102-1-102-1-102-1-102-1-102-1-102-1-102-1-102-1-102-1-102-1-102-1-102-1-102-1-102-1-1
09010500-1-100-1-100-1-100-1-100-1-100-1-100-1-102-1-102-1-102-1-102-1-102-1-102-1-102-1-102-1-102-1-102-1-102-1-102-1-102-1-102-1-102-1-102-1-102-1-102-1-102-1-102-1-102-1-102-1-102-1-102-1-102-1-102-1-102-1-102-1-102-1-102-1-102-1-102-1-102-1-102-1-102-1-102-1-102-1-102-1-102-1-102-1-102-1-102-1-102-1-102-1-102-1-102-1-102-1-102-1-102-1-102-1-102-1-102-1-102-1-102-1-102-1-1
00-1-100-1-100-1-100-1-100-1-100-1-100-1-100-1-102-1-102-1-102-1-102-1-102-1-102-1-102-1-102-1-102-1-102-1-102-1-102-1-102-1-102-1-102-1-102-1-102-1-102-1-102-1-102-1-102-1-102-1-102-1-102-1-102-1-102-1-102-1-102-1-102-1-102-1-102-1-102-1-102-1-102-1-102-1-102-1-102-1-102-1-102-1-102-1-102-1-102-1-102-1-102-1-102-1-102-1-102-1-102-1-102-1-102-1-102-1-102-1-102-1-102-1-102-1-1
00-1-100-1-100-1-100-1-100-1-102-1-100-1-100-1-102-1-102-1-102-1-102-1-102-1-102-1-102-1-102-1-102-1-102-1-102-1-102-1-102-1-102-1-102-1-102-1-102-1-102-1-102-1-102-1-102-1-102-1-102-1-102-1-102-1-102-1-102-1-102-1-102-1-102-1-102-1-102-1-102-1-102-1-102-1-102-1-102-1-102-1-102-1-102-1-102-1-102-1-102-1-102-1-102-1-102-1-102-1-102-1-102-1-102-1-102-1-102-1-102-1-102-1-102-1-1
00-1-100-1-100-1-100-1-100-1-102-1-100-1-102-1-100-1-102-1-102-1-102-1-102-1-102-1-102-1-102-1-102-1-102-1-102-1-102-1-102-1-102-1-102-1-102-1-102-1-102-1-102-1-102-1-102-1-102-1-102-1-102-1-102-1-102-1-102-1-102-1-102-1-102-1-102-1-102-1-102-1-102-1-102-1-102-1-102-1-102-1-102-1-102-1-102-1-102-1-102-1-102-1-102-1-102-1-102-1-102-1-102-1-102-1-102-1-102-1-102-1-102-1-102-1-1
00-1-100-1-100-1-102-1-100-1-102-1-102-1-100-1-102-1-102-1-102-1-102-1-102-1-102-1-102-1-102-1-102-1-102-1-102-1-102-1-102-1-102-1-102-1-102-1-102-1-102-1-102-1-102-1-102-1-102-1-102-1-102-1-102-1-102-1-102-1-102-1-102-1-102-1-102-1-102-1-102-1-102-1-102-1-102-1-102-1-102-1-102-1-102-1-102-1-102-1-102-1-102-1-102-1-102-1-102-1-102-1-102-1-102-1-102-1-102-1-102-1-102-1-102-1-1
00-1-100-1-100-1-100-1-102-1-100-1-100-1-102-1-102-1-102-1-102-1-102-1-102-1-102-1-102-1-102-1-102-1-102-1-102-1-102-1-102-1-102-1-102-1-102-1-102-1-102-1-102-1-102-1-102-1-102-1-102-1-102-1-102-1-102-1-102-1-102-1-102-1-102-1-102-1-102-1-102-1-102-1-102-1-102-1-102-1-102-1-102-1-102-1-102-1-102-1-102-1-102-1-102-1-102-1-102-1-102-1-102-1-102-1-102-1-102-1-102-1-102-1-102-1-1
00-1-100-1-100-1-100-1-100-1-100-1-102-1-102-1-102-1-102-1-102-1-102-1-102-1-102-1-102-1-102-1-102-1-102-1-102-1-102-1-102-1-102-1-102-1-102-1-102-1-102-1-102-1-102-1-102-1-102-1-102-1-102-1-102-1-102-1-102-1-102-1-102-1-102-1-102-1-102-1-102-1-102-1-102-1-102-1-102-1-102-1-102-1-102-1-102-1-102-1-102-1-102-1-102-1-102-1-102-1-102-1-102-1-102-1-102-1-102-1-102-1-102-1-102-1-1
00-1-100-1-100-1-100-1-100-1-100-1-102-1-102-1-102-1-102-1-102-1-102-1-102-1-102-1-102-1-102-1-102-1-102-1-102-1-102-1-102-1-102-1-102-1-102-1-102-1-102-1-102-1-102-1-102-1-102-1-102-1-102-1-102-1-102-1-102-1-102-1-102-1-102-1-102-1-102-1-102-1-102-1-102-1-102-1-102-1-102-1-102-1-102-1-102-1-102-1-102-1-102-1-102-1-102-1-102-1-102-1-102-1-102-1-102-1-102-1-102-1-102-1-102-1-1
00-1-100-1-100-1-100-1-100-1-100-1-100-1-102-1-102-1-102-1-102-1-102-1-102-1-102-1-102-1-102-1-102-1-102-1-102-1-102-1-102-1-102-1-102-1-102-1-102-1-102-1-102-1-102-1-102-1-102-1-102-1-102-1-102-1-102-1-102-1-102-1-102-1-102-1-102-1-102-1-102-1-102-1-102-1-102-1-102-1-102-1-102-1-102-1-102-1-102-1-102-1-102-1-102-1-102-1-102-1-102-1-102-1-102-1-102-1-102-1-102-1-102-1-102-1-1
00-1-100-1-100-1-100-1-100-1-102-1-102-1-102-1-102-1-102-1-102-1-102-1-102-1-102-1-102-1-102-1-102-1-102-1-102-1-102-1-102-1-102-1-102-1-102-1-102-1-102-1-102-1-102-1-102-1-102-1-102-1-102-1-102-1-102-1-102-1-102-1-102-1-102-1-102-1-102-1-102-1-102-1-102-1-102-1-102-1-102-1-102-1-102-1-102-1-102-1-102-1-102-1-102-1-102-1-102-1-102-1-102-1-102-1-102-1-102-1-102-1-102-1-102-1-1
00-1-100-1-100-1-100-1-100-1-100-1-102-1-102-1-102-1-102-1-102-1-102-1-102-1-102-1-102-1-102-1-102-1-102-1-102-1-102-1-102-1-102-1-102-1-102-1-102-1-102-1-102-1-102-1-102-1-102-1-102-1-102-1-102-1-102-1-102-1-102-1-102-1-102-1-102-1-102-1-102-1-102-1-102-1-102-1-102-1-102-1-102-1-102-1-102-1-102-1-102-1-102-1-102-1-102-1-102-1-102-1-102-1-102-1-102-1-102-1-102-1-102-1-102-1-1
00-1-100-1-100-1-100-1-100-1-100-1-102-1-102-1-102-1-102-1-102-1-102-1-102-1-102-1-102-1-102-1-102-1-102-1-102-1-102-1-102-1-102-1-102-1-102-1-102-1-102-1-102-1-102-1-102-1-102-1-102-1-102-1-102-1-102-1-102-1-102-1-102-1-102-1-102-1-102-1-102-1-102-1-102-1-102-1-102-1-102-1-102-1-102-1-102-1-102-1-102-1-102-1-102-1-102-1-102-1-102-1-102-1-102-1-102-1-102-1-102-1-102-1-102-1-1
00-1-100-1-100-1-100-1-100-1-102-1-102-1-102-1-102-1-102-1-102-1-102-1-102-1-102-1-102-1-102-1-102-1-102-1-102-1-102-1-102-1-102-1-102-1-102-1-102-1-102-1-102-1-102-1-102-1-102-1-102-1-102-1-102-1-102-1-102-1-102-1-102-1-102-1-102-1-102-1-102-1-102-1-102-1-102-1-102-1-102-1-102-1-102-1-102-1-102-1-102-1-102-1-102-1-102-1-102-1-102-1-102-1-102-1-102-1-102-1-102-1-102-1-102-1-1
00-1-100-1-100-1-100-1-100-1-102-1-102-1-102-1-102-1-102-1-102-1-102-1-102-1-102-1-102-1-102-1-102-1-102-1-102-1-102-1-102-1-102-1-102-1-102-1-102-1-102-1-102-1-102-1-102-1-102-1-102-1-102-1-102-1-102-1-102-1-102-1-102-1-102-1-102-1-102-1-102-1-102-1-102-1-102-1-102-1-102-1-102-1-102-1-102-1-102-1-102-1-102-1-102-1-102-1-102-1-102-1-102-1-102-1-102-1-102-1-102-1-102-1-102-1-1
00-1-100-1-100-1-100-1-100-1-100-1-102-1-102-1-102-1-102-1-102-1-102-1-102-1-102-1-102-1-102-1-102-1-102-1-102-1-102-1-102-1-102-1-102-1-102-1-102-1-102-1-102-1-102-1-102-1-102-1-102-1-102-1-102-1-102-1-102-1-102-1-102-1-102-1-102-1-102-1-102-1-102-1-102-1-102-1-102-1-102-1-102-1-102-1-102-1-102-1-102-1-102-1-102-1-102-1-102-1-102-1-102-1-102-1-102-1-102-1-102-1-102-1-102-1-1
00-1-100-1-100-1-100-1-102-1-102-1-102-1-102-1-102-1-102-1-102-1-102-1-102-1-102-1-102-1-102-1-102-1-102-1-102-1-102-1-102-1-102-1-102-1-102-1-102-1-102-1-102-1-102-1-102-1-102-1-102-1-102-1-102-1-102-1-102-1-102-1-102-1-102-1-102-1-102-1-102-1-102-1-102-1-102-1-102-1-102-1-102-1-102-1-102-1-102-1-102-1-102-1-102-1-102-1-102-1-102-1-102-1-102-1-102-1-102-1-102-1-102-1-102-1-1
00-1-100-1-100-1-100-1-100-1-102-1-100-1-100-1-102-1-102-1-102-1-102-1-102-1-102-1-102-1-102-1-102-1-102-1-102-1-102-1-102-1-102-1-102-1-102-1-102-1-102-1-102-1-102-1-102-1-102-1-102-1-102-1-102-1-102-1-102-1-102-1-102-1-102-1-102-1-102-1-102-1-102-1-102-1-102-1-102-1-102-1-102-1-102-1-102-1-102-1-102-1-102-1-102-1-102-1-102-1-102-1-102-1-102-1-102-1-102-1-102-1-102-1-102-1-1
00-1-100-1-100-1-100-1-102-1-100-1-102-1-102-1-102-1-102-1-102-1-102-1-102-1-102-1-102-1-102-1-102-1-102-1-102-1-102-1-102-1-102-1-102-1-102-1-102-1-102-1-102-1-102-1-102-1-102-1-102-1-102-1-102-1-102-1-102-1-102-1-102-1-102-1-102-1-102-1-102-1-102-1-102-1-102-1-102-1-102-1-102-1-102-1-102-1-102-1-102-1-102-1-102-1-102-1-102-1-102-1-102-1-102-1-102-1-102-1-102-1-102-1-102-1-1
00-1-100-1-100-1-102-1-100-1-100-1-102-1-102-1-102-1-102-1-102-1-102-1-102-1-102-1-102-1-102-1-102-1-102-1-102-1-102-1-102-1-102-1-102-1-102-1-102-1-102-1-102-1-102-1-102-1-102-1-102-1-102-1-102-1-102-1-102-1-102-1-102-1-102-1-102-1-102-1-102-1-102-1-102-1-102-1-102-1-102-1-102-1-102-1-102-1-102-1-102-1-102-1-102-1-102-1-102-1-102-1-102-1-102-1-102-1-102-1-102-1-102-1-102-1-1
00-1-100-1-100-1-100-1-100-1-102-1-102-1-102-1-102-1-102-1-102-1-102-1-102-1-102-1-102-1-102-1-102-1-102-1-102-1-102-1-102-1-102-1-102-1-102-1-102-1-102-1-102-1-102-1-102-1-102-1-102-1-102-1-102-1-102-1-102-1-102-1-102-1-102-1-102-1-102-1-102-1-102-1-102-1-102-1-102-1-102-1-102-1-102-1-102-1-102-1-102-1-102-1-102-1-102-1-102-1-102-1-102-1-102-1-102-1-102-1-102-1-102-1-102-1-1
02-1-102-1-100-1-100-1-100-1-102-1-102-1-102-1-102-1-102-1-102-1-102-1-102-1-102-1-102-1-102-1-102-1-102-1-102-1-102-1-102-1-102-1-102-1-102-1-102-1-102-1-102-1-102-1-102-1-102-1-102-1-102-1-102-1-102-1-102-1-102-1-102-1-102-1-102-1-102-1-102-1-102-1-102-1-102-1-102-1-102-1-102-1-102-1-102-1-102-1-102-1-102-1-102-1-102-1-102-1-102-1-102-1-102-1-102-1-102-1-102-1-102-1-102-1-1
00-1-100-1-100-1-102-1-102-1-102-1-102-1-102-1-102-1-102-1-102-1-102-1-102-1-102-1-102-1-102-1-102-1-102-1-102-1-102-1-102-1-102-1-102-1-102-1-102-1-102-1-102-1-102-1-102-1-102-1-102-1-102-1-102-1-102-1-102-1-102-1-102-1-102-1-102-1-102-1-102-1-102-1-102-1-102-1-102-1-102-1-102-1-102-1-102-1-102-1-102-1-102-1-102-1-102-1-102-1-102-1-102-1-102-1-102-1-102-1-102-1-102-1-102-1-1
02-1-102-1-100-1-102-1-102-1-102-1-102-1-102-1-102-1-102-1-102-1-102-1-102-1-102-1-102-1-102-1-102-1-102-1-102-1-102-1-102-1-102-1-102-1-102-1-102-1-102-1-102-1-102-1-102-1-102-1-102-1-102-1-102-1-102-1-102-1-102-1-102-1-102-1-102-1-102-1-102-1-102-1-102-1-102-1-102-1-102-1-102-1-102-1-102-1-102-1-102-1-102-1-102-1-102-1-102-1-102-1-102-1-102-1-102-1-102-1-102-1-102-1-102-1-1
02-1-102-1-102-1-102-1-102-1-102-1-102-1-102-1-102-1-102-1-102-1-102-1-102-1-102-1-102-1-102-1-102-1-102-1-102-1-102-1-102-1-102-1-102-1-102-1-102-1-102-1-102-1-102-1-102-1-102-1-102-1-102-1-102-1-102-1-102-1-102-1-102-1-102-1-102-1-102-1-102-1-102-1-102-1-102-1-102-1-102-1-102-1-102-1-102-1-102-1-102-1-102-1-102-1-102-1-102-1-102-1-102-1-102-1-102-1-102-1-102-1-102-1-102-1-1
02-1-102-1-102-1-102-1-102-1-102-1-102-1-102-1-102-1-102-1-102-1-102-1-102-1-102-1-102-1-102-1-102-1-102-1-102-1-102-1-102-1-102-1-102-1-102-1-102-1-102-1-102-1-102-1-102-1-102-1-102-1-102-1-102-1-102-1-102-1-102-1-102-1-102-1-102-1-102-1-102-1-102-1-102-1-102-1-102-1-102-1-102-1-102-1-102-1-102-1-102-1-102-1-102-1-102-1-102-1-102-1-102-1-102-1-102-1-102-1-102-1-102-1-102-1-1
02-1-102-1-102-1-102-1-102-1-102-1-102-1-102-1-102-1-102-1-102-1-102-1-102-1-102-1-102-1-102-1-102-1-102-1-102-1-102-1-102-1-102-1-102-1-102-1-102-1-102-1-102-1-102-1-102-1-102-1-102-1-102-1-102-1-102-1-102-1-102-1-102-1-102-1-102-1-102-1-102-1-102-1-102-1-102-1-102-1-102-1-102-1-102-1-102-1-102-1-102-1-102-1-102-1-102-1-102-1-102-1-102-1-102-1-102-1-102-1-102-1-102-1-102-1-1
02-1-102-1-102-1-102-1-102-1-102-1-102-1-102-1-102-1-102-1-102-1-102-1-102-1-102-1-102-1-102-1-102-1-102-1-102-1-102-1-102-1-102-1-102-1-102-1-102-1-102-1-102-1-102-1-102-1-102-1-102-1-102-1-102-1-102-1-102-1-102-1-102-1-102-1-102-1-102-1-102-1-102-1-102-1-102-1-102-1-102-1-102-1-102-1-102-1-102-1-102-1-102-1-102-1-102-1-102-1-102-1-102-1-102-1-102-1-102-1-102-1-102-1-102-1-1
02-1-102-1-102-1-102-1-102-1-102-1-102-1-102-1-102-1-102-1-102-1-102-1-102-1-102-1-102-1-102-1-102-1-102-1-102-1-102-1-102-1-102-1-102-1-102-1-102-1-102-1-102-1-102-1-102-1-102-1-102-1-102-1-102-1-102-1-102-1-102-1-102-1-102-1-102-1-102-1-102-1-102-1-102-1-102-1-102-1-102-1-102-1-102-1-102-1-102-1-102-1-102-1-102-1-102-1-102-1-102-1-102-1-102-1-102-1-102-1-102-1-102-1-102-1-1
02-1-102-1-102-1-102-1-102-1-102-1-102-1-102-1-102-1-102-1-102-1-102-1-102-1-102-1-102-1-102-1-102-1-102-1-102-1-102-1-102-1-102-1-102-1-102-1-102-1-102-1-102-1-102-1-102-1-102-1-102-1-102-1-102-1-102-1-102-1-102-1-102-1-102-1-102-1-102-1-102-1-102-1-102-1-102-1-102-1-102-1-102-1-102-1-102-1-102-1-102-1-102-1-102-1-102-1-102-1-102-1-102-1-102-1-102-1-102-1-102-1-102-1-102-1-1
02-1-102-1-102-1-102-1-102-1-102-1-102-1-102-1-102-1-102-1-102-1-102-1-102-1-102-1-102-1-102-1-102-1-102-1-102-1-102-1-102-1-102-1-102-1-102-1-102-1-102-1-102-1-102-1-102-1-102-1-102-1-102-1-102-1-102-1-102-1-102-1-102-1-102-1-102-1-102-1-102-1-102-1-102-1-102-1-102-1-102-1-102-1-102-1-102-1-102-1-102-1-102-1-102-1-102-1-102-1-102-1-102-1-102-1-102-1-102-1-102-1-102-1-102-1-1
02-1-102-1-102-1-102-1-102-1-102-1-102-1-102-1-102-1-102-1-102-1-102-1-102-1-102-1-102-1-102-1-102-1-102-1-102-1-102-1-102-1-102-1-102-1-102-1-102-1-102-1-102-1-102-1-102-1-102-1-102-1-102-1-102-1-102-1-102-1-102-1-102-1-102-1-102-1-102-1-102-1-102-1-102-1-102-1-102-1-102-1-102-1-102-1-102-1-102-1-102-1-102-1-102-1-102-1-102-1-102-1-102-1-102-1-102-1-102-1-102-1-102-1-102-1-1
02-1-102-1-102-1-102-1-102-1-102-1-102-1-102-1-102-1-102-1-102-1-102-1-102-1-102-1-102-1-102-1-102-1-102-1-102-1-102-1-102-1-102-1-102-1-102-1-102-1-102-1-102-1-102-1-102-1-102-1-102-1-102-1-102-1-102-1-102-1-102-1-102-1-102-1-102-1-102-1-102-1-102-1-102-1-102-1-102-1-102-1-102-1-102-1-102-1-102-1-102-1-102-1-102-1-102-1-102-1-102-1-102-1-102-1-102-1-102-1-102-1-102-1-102-1-1
02-1-102-1-102-1-102-1-102-1-102-1-102-1-102-1-102-1-102-1-102-1-102-1-102-1-102-1-102-1-102-1-102-1-102-1-102-1-102-1-102-1-102-1-102-1-102-1-102-1-102-1-102-1-102-1-102-1-102-1-102-1-102-1-102-1-102-1-102-1-102-1-102-1-102-1-102-1-102-1-102-1-102-1-102-1-102-1-102-1-102-1-102-1-102-1-102-1-102-1-102-1-102-1-102-1-102-1-102-1-102-1-102-1-102-1-102-1-102-1-102-1-102-1-102-1-1
02-1-102-1-102-1-102-1-102-1-102-1-102-1-102-1-102-1-102-1-102-1-102-1-102-1-102-1-102-1-102-1-102-1-102-1-102-1-102-1-102-1-102-1-102-1-102-1-102-1-102-1-102-1-102-1-102-1-102-1-102-1-102-1-102-1-102-1-102-1-102-1-102-1-102-1-102-1-102-1-102-1-102-1-102-1-102-1-102-1-102-1-102-1-102-1-102-1-102-1-102-1-102-1-102-1-102-1-102-1-102-1-102-1-102-1-102-1-102-1-102-1-102-1-102-1-1
02-1-102-1-102-1-102-1-102-1-102-1-102-1-102-1-102-1-102-1-102-1-102-1-102-1-102-1-102-1-102-1-102-1-102-1-102-1-102-1-102-1-102-1-102-1-102-1-102-1-102-1-102-1-102-1-102-1-102-1-102-1-102-1-102-1-102-1-102-1-102-1-102-1-102-1-102-1-102-1-102-1-102-1-102-1-102-1-102-1-102-1-102-1-102-1-102-1-102-1-102-1-102-1-102-1-102-1-102-1-102-1-102-1-102-1-102-1-102-1-102-1-102-1-102-1-1
02-1-102-1-102-1-102-1-102-1-102-1-102-1-102-1-102-1-102-1-102-1-102-1-102-1-102-1-102-1-102-1-102-1-102-1-102-1-102-1-102-1-102-1-102-1-102-1-102-1-102-1-102-1-102-1-102-1-102-1-102-1-102-1-102-1-102-1-102-1-102-1-102-1-102-1-102-1-102-1-102-1-102-1-102-1-102-1-102-1-102-1-102-1-102-1-102-1-102-1-102-1-102-1-102-1-102-1-102-1-102-1-102-1-102-1-102-1-102-1-102-1-102-1-102-1-1
02-1-102-1-102-1-102-1-102-1-102-1-102-1-102-1-102-1-102-1-102-1-102-1-102-1-102-1-102-1-102-1-102-1-102-1-102-1-102-1-102-1-102-1-102-1-102-1-102-1-102-1-102-1-102-1-102-1-102-1-102-1-102-1-102-1-102-1-102-1-102-1-102-1-102-1-102-1-102-1-102-1-102-1-102-1-102-1-102-1-102-1-102-1-102-1-102-1-102-1-102-1-102-1-102-1-102-1-102-1-102-1-102-1-102-1-102-1-102-1-102-1-102-1-102-1-1
02-1-102-1-102-1-102-1-102-1-102-1-102-1-102-1-102-1-102-1-102-1-102-1-102-1-102-1-102-1-102-1-102-1-102-1-102-1-102-1-102-1-102-1-102-1-102-1-102-1-102-1-102-1-102-1-102-1-102-1-102-1-102-1-102-1-102-1-102-1-102-1-102-1-102-1-102-1-102-1-102-1-102-1-102-1-102-1-102-1-102-1-102-1-102-1-102-1-102-1-102-1-102-1-102-1-102-1-102-1-102-1-102-1-102-1-102-1-102-1-102-1-102-1-102-1-1
02-1-102-1-102-1-102-1-102-1-102-1-102-1-102-1-102-1-102-1-102-1-102-1-102-1-102-1-102-1-102-1-102-1-102-1-102-1-102-1-102-1-102-1-102-1-102-1-102-1-102-1-102-1-102-1-102-1-102-1-102-1-102-1-102-1-102-1-102-1-102-1-102-1-102-1-102-1-102-1-102-1-102-1-102-1-102-1-102-1-102-1-102-1-102-1-102-1-102-1-102-1-102-1-102-1-102-1-102-1-102-1-102-1-102-1-102-1-102-1-102-1-102-1-102-1-1
02-1-102-1-102-1-102-1-102-1-102-1-102-1-102-1-102-1-102-1-102-1-102-1-102-1-102-1-102-1-102-1-102-1-102-1-102-1-102-1-102-1-102-1-102-1-102-1-102-1-102-1-102-1-102-1-102-1-102-1-102-1-102-1-102-1-102-1-102-1-102-1-102-1-102-1-102-1-102-1-102-1-102-1-102-1-102-1-102-1-102-1-102-1-102-1-102-1-102-1-102-1-102-1-102-1-102-1-102-1-102-1-102-1-102-1-102-1-102-1-102-1-102-1-102-1-1
02-1-102-1-102-1-102-1-102-1-102-1-102-1-102-1-102-1-102-1-102-1-102-1-102-1-102-1-102-1-102-1-102-1-102-1-102-1-102-1-102-1-102-1-102-1-102-1-102-1-102-1-102-1-102-1-102-1-102-1-102-1-102-1-102-1-102-1-102-1-102-1-102-1-102-1-102-1-102-1-102-1-102-1-102-1-102-1-102-1-102-1-102-1-102-1-102-1-102-1-102-1-102-1-102-1-102-1-102-1-102-1-102-1-102-1-102-1-102-1-102-1-102-1-102-1-1
02-1-102-1-102-1-102-1-102-1-102-1-102-1-102-1-102-1-102-1-102-1-102-1-102-1-102-1-102-1-102-1-102-1-102-1-102-1-102-1-102-1-102-1-102-1-102-1-102-1-102-1-102-1-102-1-102-1-102-1-102-1-102-1-102-1-102-1-102-1-102-1-102-1-102-1-102-1-102-1-102-1-102-1-102-1-102-1-102-1-102-1-102-1-102-1-102-1-102-1-102-1-102-1-102-1-102-1-102-1-102-1-102-1-102-1-102-1-102-1-102-1-102-1-102-1-1
02-1-102-1-102-1-102-1-102-1-102-1-102-1-102-1-102-1-102-1-102-1-102-1-102-1-102-1-102-1-102-1-102-1-102-1-102-1-102-1-102-1-102-1-102-1-102-1-102-1-102-1-102-1-102-1-102-1-102-1-102-1-102-1-102-1-102-1-102-1-102-1-102-1-102-1-102-1-102-1-102-1-102-1-102-1-102-1-102-1-102-1-102-1-102-1-102-1-102-1-102-1-102-1-102-1-102-1-102-1-102-1-102-1-102-1-102-1-102-1-102-1-102-1-102-1-1
02-1-102-1-102-1-102-1-102-1-102-1-102-1-102-1-102-1-102-1-102-1-102-1-102-1-102-1-102-1-102-1-102-1-102-1-102-1-102-1-102-1-102-1-102-1-102-1-102-1-102-1-102-1-102-1-102-1-102-1-102-1-102-1-102-1-102-1-102-1-102-1-102-1-102-1-102-1-102-1-102-1-102-1-102-1-102-1-102-1-102-1-102-1-102-1-102-1-102-1-102-1-102-1-102-1-102-1-102-1-102-1-102-1-102-1-102-1-102-1-102-1-102-1-102-1-1
02-1-102-1-102-1-102-1-102-1-102-1-102-1-102-1-102-1-102-1-102-1-102-1-102-1-102-1-102-1-102-1-102-1-102-1-102-1-102-1-102-1-102-1-102-1-102-1-102-1-102-1-102-1-102-1-102-1-102-1-102-1-102-1-102-1-102-1-102-1-102-1-102-1-102-1-102-1-102-1-102-1-102-1-102-1-102-1-102-1-102-1-102-1-102-1-102-1-102-1-102-1-102-1-102-1-102-1-102-1-102-1-102-1-102-1-102-1-102-1-102-1-102-1-102-1-1
02-1-102-1-102-1-102-1-102-1-102-1-102-1-102-1-102-1-102-1-102-1-102-1-102-1-102-1-102-1-102-1-102-1-102-1-102-1-102-1-102-1-102-1-102-1-102-1-102-1-102-1-102-1-102-1-102-1-102-1-102-1-102-1-102-1-102-1-102-1-102-1-102-1-102-1-102-1-102-1-102-1-102-1-102-1-102-1-102-1-102-1-102-1-102-1-102-1-102-1-102-1-102-1-102-1-102-1-102-1-102-1-102-1-102-1-102-1-102-1-102-1-102-1-102-1-1
02-1-102-1-102-1-102-1-102-1-102-1-102-1-102-1-102-1-102-1-102-1-102-1-102-1-102-1-102-1-102-1-102-1-102-1-102-1-102-1-102-1-102-1-102-1-102-1-102-1-102-1-102-1-102-1-102-1-102-1-102-1-102-1-102-1-102-1-102-1-102-1-102-1-102-1-102-1-102-1-102-1-102-1-102-1-102-1-102-1-102-1-102-1-102-1-102-1-102-1-102-1-102-1-102-1-102-1-102-1-102-1-102-1-102-1-102-1-102-1-102-1-102-1-102-1-1
02-1-102-1-102-1-102-1-102-1-102-1-102-1-102-1-102-1-102-1-102-1-102-1-102-1-102-1-102-1-102-1-102-1-102-1-102-1-102-1-102-1-102-1-102-1-102-1-102-1-102-1-102-1-102-1-102-1-102-1-102-1-102-1-102-1-102-1-102-1-102-1-102-1-102-1-102-1-102-1-102-1-102-1-102-1-102-1-102-1-102-1-102-1-102-1-102-1-102-1-102-1-102-1-102-1-102-1-102-1-102-1-102-1-102-1-102-1-102-1-102-1-102-1-102-1-1
02-1-102-1-102-1-102-1-102-1-102-1-102-1-102-1-102-1-102-1-102-1-102-1-102-1-102-1-102-1-102-1-102-1-102-1-102-1-102-1-102-1-102-1-102-1-102-1-102-1-102-1-102-1-102-1-102-1-102-1-102-1-102-1-102-1-102-1-102-1-102-1-102-1-102-1-102-1-102-1-102-1-102-1-102-1-102-1-102-1-102-1-102-1-102-1-102-1-102-1-102-1-102-1-102-1-102-1-102-1-102-1-102-1-102-1-102-1-102-1-102-1-102-1-102-1-1
02-1-102-1-102-1-102-1-102-1-102-1-102-1-102-1-102-1-102-1-102-1-102-1-102-1-102-1-102-1-102-1-102-1-102-1-102-1-102-1-102-1-102-1-102-1-102-1-102-1-102-1-102-1-102-1-102-1-102-1-102-1-102-1-102-1-102-1-102-1-102-1-102-1-102-1-102-1-102-1-102-1-102-1-102-1-102-1-102-1-102-1-102-1-102-1-102-1-102-1-102-1-102-1-102-1-102-1-102-1-102-1-102-1-102-1-102-1-102-1-102-1-102-1-102-1-1
