63
51
020070190200701902007019020070190200701902007019020070190200701902007019020070190200701902007019020070190200701902007019020070190200701902007019020070190200701902007019020070190200701902007019020070190200701902007019020070190200701902007019020000000202001802020019020200190202001902020019020200190202001902020021020000000200000002000000020000000200000002000000020000000200000002000000020000000200000002000000020000000200000002000000020000000200000002000000020000000100400101003002010050010100300201003002
020070190200701902007019020070190200701902007019020070190200701902007019020070190200701902007019020070190200701902007019020070190200701902007019020070190200701902007019020070190200701902007019020070190200701902007019020070190200701902007019020000000202001802020019020200190202001902020019020200190202001902020021020000000200000002007019020070190200701902007019020070190200701902007019020070190200701902007019020070190200701902007019020070190200701902007019020000000100400101003002010040010100300201003002
020070190200701902007019020070190200701902007019020070190200701902007019020070190200701902007019020070190200701902007019020070190200701902007019020070190200701902007019020070190200701902007019020070190200701902007019020070190200701902007019020000000202001802020019020200190202001902020019020200190202001902020021020070190200701902007019020070190200701902007019020070190200701902007019020070190200701902007019020070190200701902007019020070190200701902007019020000000100400101003002010040010100300201003002
020070190200701902007019020070190200701902007019020070190200701902007019020070190200701902007019020070190200701902007019020070190200701902007019020070190200701902007019020070190200701902007019020070190200701902007019020070190200701902007019020000000202001802020019020200190202001902020019020200190202001902020021020000000200701902007019020070190200701902007019020070190200701902007019020070190200701902007019020070190200701902007019020070190200701902007019020000000100400101003002010040010100300201003002
020070190200701902007019020070190200000002000000020000000200000002000000020000000200000002000000020000000200000002000000020000000200000002000000020000000200000002000000020000000200000002000000020000000200000002000000020000000200000002000000020000000202001802020019020200190202001902020019020200190202001902020021020000000200000002000000020000000200000002000000020000000200000002000000020000000200000002000000020000000200000002000000020000000200000002000000020000000100400101003002010040010100300201003002
020070190200701902007019020070190200000002000000020000000200000002000000020000000200000002000000020000000200000002000000020000000200000002000000020000000200000002000000020000000200000002000000020000000200000002000000020000000200000002000000020000000202001802020019020200190202001902020019020200190202001902020021020000000200000002000000020000000200000002000000020000000200000002000000020000000200000002000000020000000200000002000000020000000200000002000000020000000100400101003002010040010100300201003002
020070190200701902007019020070190200000002000000020000000200000002000000020000000200000002000000020000000200000002000000020000000200000002000000020000000200000002000000020000000200000002000000020000000200000002000000020000000200000002000000020000000202001802020019020200190202001902020019020200190202001902020021020000000200000002000000020000000200000002000000020000000200000002000000020000000200000002000000020000000200000002000000020000000200000002000000020000000100400101003002010040010100300201003002
020070190200701902007019020070190200000002000000020000000200000002000000020000000200000002000000020000000200000002000000020000000200000002000000020000000200000002000000020000000200000002000000020000000200000002000000020000000200000002000000020000000202001802020019020200190202001902020019020200190202001902020021020000000200000002000000020000000200000002000000020000000200000002000000020000000200000002000000020000000200000002000000020000000200000002000000020000000100400101003002010040010100300201003002
020070190200701902007019020070190200000002000000020000000200000002019018020190190201901902019019020190190201901902019019020190190201901902019019020190190201901902019019020190190201901902019019020190190201901902019019020190190201901902019021020000000202001802020019020200190202001902020019020200190202001902023019020190200201902002019020020190200201902002019020020190200201902002019020020190200201902002019020020190200201902002019020020190210200000002000000020000000100400101003002010040010100300201003002
020070190200701902007019020070190200000002000000020000000200000002020018020200190202001902020019020200190202001902020019020200190202001902020019020200190202001902020019020200190202001902020019020200190202001902020019020200190202001902020021020000000202001802020019020200190202001902020019020200190202001902020019020200190202002002020019020200190202002002020020020200190202001902020019020200190202001902020019020200190202001902020019020200210200000002000000020000000100400101003002010040010100300201003002
020070190200701902007019020070190200000002000000020000000200000002020018020200190202001902020019020200190202001902020019020200190202001902020019020200190202001902020019020200190202001902020019020200190202001902020019020200190202001902021021020000000202001802020019020200190202001902020019020200190202001902020019020200190202002002020019020200190202002002020020020200190202001902020019020200190202001902020019020200190202001902020019020200210200000002000000020000000100400101003002010040010100300201003002
020070190200701902007019020070190200000002000000020000000200000002020018020200190202001902020019020200190202001902020019020200190202001902020019020200190202001902020019020200190202001902020019020200190202001902020019020200190202001902021021020000000202001802020019020200190202001902020019020200190202001902020019020200190202002002020019020200190202002002020019020200190202001902020019020200190202002002020020020200190202001902020019020200210200000002000000020000000100400101003002010040010100300201003002
020070190200701902007019020070190200000002000000020000000200000002020018020200190202001902020019020200190202001902020019020200190202001902020019020200190202001902020019020200190202001902020019020200190202001902020019020200190202001902021021020000000202001802020019020200190202001902020019020200190202001902020019020200190202002002020020020200200202002002020019020200190202001902020019020200190202001902020019020200190202001902020020020200210200000002000000020000000100400101003002010040010100300201003002
020070190200701902007019020070190200000002000000020000000200000002020018020200190202001902020019020200190202001902020019020200190202001902020019020200190202001902020019020200190202001902020019020200190202001902020019020200190202001902021021020000000202001802020020020200200202002002020020020200200202002002020020020200200202002002020020020200200202002002020020020200200202002002020020020200200202002002020019020200190202001902020019020200210200000002000000020000000100400101003002010040010100300201003002
020070190200701902007019020070190200000002000000020000000200000002022018020220190202202002022020020220200202202002022020020220200202202002022020020220200202202002022020020220200202202002022020020220200202202002022020020220200202202002022021020000000202201802022019020220190202201902022019020220190202201902022019020220190202202002022020020220200202202002022020020220200202202002022020020220200202202002022020020220200202202002022020020220210200000002000000020000000100400101003002010040010100300201003002
020070190200701902007019020070190200000002000000020000000200000002000000020000000200000002000000020000000200000002000000020000000200000002000000020000000200000002000000020000000200000002000000020000000200000002000000020000000200000002000000020000000200000002000000020000000200000002000000020000000200000002000000020000000200000002000000020000000200000002000000020000000200000002000000020000000200000002000000020000000200000002000000020000000200000002000000020000000100400101003002010040010100300201003002
020070190200701902007019020070190200000002000000020000000200000002000000020000000200000002000000020000000200000002000000020000000200000002000000020000000200000002000000020000000200000002000000020000000200000002000000020000000200000002000000020000000200000002000000020000000200000002000000020000000200000002000000020000000200000002000000020000000200000002000000020000000200000002000000020000000200000002000000020000000200000002000000020000000200000002000000020000000100400101003002010040010100300201003002
020070190200701902007019020070190200000002000000020000000200000002019018020190190201901902019019020190190201901902019019020190190201901902019019020190190201901902019019020190190201901902019019020190190201901902019019020190190201901902019020020190200201902002019020020190200201902002019020020190200201902002019021020000000200000002019018020190200201902002019020020190200201902002019020020190200201902002019020020190200201902002019020020190210200000002000000020000000100400101003002010040010100300201003002
020070190200701902007019020070190200000002000000020000000200000002020018020200190202001902020019020200190202001902020019020200190202001902020020020200190202001902020019020200190202001902020019020200190202001902020019020200190202002002020020020200200202002002020020020200200202002002020020020200200202002002020021020000000200000002021018020200200202002002020020020200200202002002020020020200200202002002020019020200190202001902020020020200210200000002000000020000000100400101003002010050010100300201003002
020070190200701902007019020070190200000002000000020000000200000002020018020200190202001902020019020200200000901100009011000090110202001902020019020200190202002002020020020200200202002002020019020200190202001902020020020200200202002002020020020200200202002002020020020200200202002002020020020200200202002002020021020000000200000002021018020200200202002002020020020200200202002002020020020200200202002002020019020200190202001902020020020200210200000002000000020000000100400101003002010030020100300201003002
020070190200701902007019020070190200000002000000020000000200000002020018020200190202001902020019020200200202002002020020020200200202001902020019020200190202002002020020020200200202002002020019020200200202002002020020020200200202002002020020020200200202002004069089020200200202002002020020020200200202002002020021020000000200000002021018020200200202002002020020020200200202002002020020020200200202002002020019020200190202001902020020020200210200000002000000020000000100400101003002010030020100300201003002
020070190200701902007019020070190200000002000000020000000200000002020018020200190202001902020019020200190202001902020020020200200202001902020019020200190202001902020019020200190202001902020019020200190202001902020020020200200202002002020020020200200202002002020020020200200202002002020020020200200202002002020021020000000200000002022018020220200202202002022020020220200202202002022020020220200202202002022020020220200202202002022020020220210200000002000000020000000100400101003002010030020100300201003002
020000000200000002000000020000000200000002000000020000000200000002020018020200190202001902020019020200190202001902020019020200190202001902020019020200190202001902020019020200190202001902020019020200200202001902020019020200200202002002020020020200200202002002020020020200200202002002020020020200200202002002020021020000000200000002000000020000000200000002000000020000000200000002000000020000000200000002000000020000000200000002000000020000000200000002000000020000000100400101003002010050010100300201003002
020000000200000002000000020000000200000002000000020000000200000002020018020200190202001902020019020200200202002002020020020200200202002002020020020200200202002002020020020200200202002002020020020200200202002002020020020200200202002002020020020200200202002002020020020200200202002002020020020200200202002002020021020000000200000002000000020000000200000002000000020000000200000002000000020000000200000002000000020000000200000002000000020000000200000002000000020000000200000001006002010060020100600201006002
020190200201902002019020020190200201902002019020020190200201902002023018020200190202001902020019020200200202002002020020020200200202002002020020020200200202002002020020020200200202002002020020020200200202002002020020020200200202002002020020020200200202002002020020040700930407009304070093040700930202002002023019020190200201902002019020020190200201902002019020020190200201902002019020020190200201902002019020020190200201902002019020020190210200000002000000020000000200000002000000020000000200000002000000
020200190202001902020019020200190202001902020019020200190202001902020019020200190202001902020019020200200202002002020020020200200202002002020020020200200202002002020020020200200202002002020020020200200202002002020020020200200202002002020020020200200202002002020020020200200202002002020020020200200202002002020020020200200202002002020020020200200202002002020020020200200202002002020020020200200202002002020019020200190202001902020020020200210200000002000000020000000200000002000000020000000200000002000000
020200190202001902020019020200190202001902020019020200190202001902020019020200190202001902020019020200190202001902020019020200190202001902020019020200190202001902020019020200190202001902020019020200200202001902020019020200190202001902020019020200200202002002020020020200200202002002020020020200200202002002020020020200190202001902020019020200190202001902020020020200200202002002020020020200200202002002020020020200190202001902020020020200210200000002000000020000000200000002000000020000000200000002000000
020200190202001902020019020200190202001902020019020200190202001902020019020200190202001902020019020200190202001902020019020200190202001902020019020200190202001902020019020200190202001902020019020200200202001902020019020200190202001902020019020200200202002002020020020200200202002002020020020200200202002002020020020200190202001902020019020200190202001902020020020200200202002002020020020200200202002002020019020200190202001902020020020200210200000002000000020000000200000002000000020000000200000002000000
020200190202001902020019020200190202001902020019020200190202001902020019020200190202001902020019020200190202001902020019020200190202001902020019020200190202001902020019020200190202001902020019020200200202001902020019020200190202001902020019020200190202002002020020020200200202002002020020020200200202002002020020020200190202001902020019020200190202001902020020020200200202002002020020020200200202002002020020020200190202001902020020020200210200000002000000020000000200000002000000020000000200000002000000
020200190202001902020019020200190202001902020019020200190202001902020019020200190202001902020019020200190202001902020019020200190202001902020019020200190202001902020019020200190202001902020019020200190202001902020019020200190202001902020019020200200202002002020020020200200202002002020020020200200202002002020020020200190202001902020019020200190202001902020019020200200202002002020020020200200202002002020020020200200202001902020020020200210200000002000000020000000200000002000000020000000200000002000000
020200190202001902020019020200190202001902020019020200190202001902020019020200190202001902020019020200190202001902020019020200190202001902020019020200190202001902020019020200190202001902020019020200190202001902020019020200190202001902020019020200200202002002020020020200200202002002020020020200200202002002020020020200190202001902020019020200190202001902020020020200200202002002020020020200200202002002020020020200200202001902020020020200210200000002000000020000000100400101004002010040010100300201003002
020220190202201902022019020220190202201902022019020220190202201902024018020200190202001902020019020200190202001902020019020200190202001902020019020200190202001902020019020200190202001902020019020200200202001902020019020200190202001902020019020200200202002002020020020200200202002002020020020200200202002002020020020200190202001902020019020200190202001902020020020200200202002002020020020200200202002002020020020200200202001902020020020200210200000002000000020000000100400101004002010040010100300201003002
020000000200000002000000020000000200000002000000020000000200000002021018020200190202001902020019020200200202002002020020020200200202002002020020020200200202002002020020020200200202002002020020020200200202002002020020020200200202002002020020020200200202002002020020020200200202002002020020020200200202002002020020020200200202002002020020020200200202002002020020020200200202002002020020020200200202002002020019020200190202001902020020020200210200000002000000020000000100400101004002010040010100300201003002
020070190200000002007019020000000200000002000000020000000200000002022018020220200202202002022020020220200202202002022020020220200202202002022020020220200202202002022020020220200202202002022020020220200202202002022020020220200202202002022020020220200202202002022020020220200202202002022020020220200202202002022020020220200202202002022020020220200202202002022020020220200202202002022020020220200202202002022020020220200202202002022020020220210200000002000000020000000100400101004002010040010100300201003002
020070190200000002007019020000000200000002000000020000000200000002000000020000000200000002000000020000000200000002000000020000000200000002000000020000000200000002000000020000000200000002000000020000000200000002000000020000000200000002000000020000000200000002000000020000000200000002000000020000000200000002000000020000000200000002000000020000000200000002000000020000000200000002000000020000000200000002000000020000000200000002000000020000000200000002000000020000000100400101004002010040010100300201003002
020070190200000002007019020000000200000002000000020000000200000002000000020000000200000002000000020000000200000002000000020000000200000002000000020000000200000002000000020000000200000002000000020000000200000002000000020000000200000002000000020000000200000002000000020000000200000002000000020000000200000002000000020000000200000002000000020000000200000002000000020000000200000002000000020000000200000002000000020000000200000002000000020000000200000002000000020000000100400101004002010040010100300201003002
020070190200000002007019020000000200000002000000020000000200000002019018020190190201901902019019020190190201901902019019020190190201901902019019020190190201901902019019020190190201901902019019020190190201901902019019020190190201901902019021020000000200000002019018020190190201901902019019020190190201901902019019020190190201901902019019020190190201901902019019020190190201901902019019020190190201901902019019020190190201901902019019020190210200000002000000020000000100400101004002010040010100300201003002
020070190200701902007019020000000200000002000000020000000200000002020018020200190202001902020019020200190202001902020019020200190202001902020019020200190202001902020019020200190202001902020019020200190202001902020019020200190202001902020021020000000200000002021018020200200202002002020020020200200202002002020020020200190202001902020019020200190202001902020019020200190202001902020019020200190202001902020019020200190202001902020019020200210200000002000000020000000100400101004002010040010100300201003002
020000000200701902007019020000000200000002000000020000000200000002020018020200190202001902020019020200190400503602020019020200190202001902020019020200190202001902020019020200190202001902020019020200190202001902020019020200190202001902020021020000000200000002021018020200200202002002020020020200200202002002020020020200190202001902020019020200190202001902020019020200190202001902020019020200190202001902020019020200190202001902020019020200210200000002000000020000000100400101004002010040010100300201003002
020170010200701902007019020000000200000002000000020000000200000002021018020210190202001902020019020200190202001902020019020200190202001902020019020200190202001902020019020200190202001902020019020200190202001902020019020200190202001902020021020000000200000002021018020200190202001902020019020200190202001902020019020200190202001902020019020200190202001902020019020200190202001902020019020200190202001902020019020200190202001902020019020200210200000002000000020000000100400101004002010040010100300201003002
020000000200701902007019020000000200000002000000020000000200000002021018020200190202001902020019020200190202001902020019020200190202001902020019020200190202001902020019020200190202001902020019020200190202001902020019020200190202001902020021020000000200000002021018020200190202001902020019020200190202001902020019020200190202001902020019020200190202001902020019020200190202001902020019020200190202001902020019020200190202001902020019020200210200000002000000020000000100400101004002010040010100300201003002
020170010200701902007019020000000200000002000000020000000200000002021018020200190202001902020019020200190202001902020019020200190202001902020019020200190202001902020019020200190202001902020019020200190202001902020019020200190202001902020021020000000200000002021018020200190202001902020019020200190202001902020019020200190202001902020019020200190202001902020019020200190202001902020019020200190202001902020019020200190202001902020020020200210200000002000000020000000100400101004002010040010100300201003002
020000000200701902007019020000000200000002000000020000000200000002021018020200190202002002020020020200190202002002020020020200200202002002020020020200200202002002020020020200200202002002020020020200200202002002020020020200200202002002020021020000000200000002021018020200200202002002020020020200200202002002020020020200200202002002020020020200200202002002020020020200200202002002020020020200200202002002020020020200200202002002020020020200210200000002000000020000000100400101004002010040010100300201003002
020070190200701902007019020000000200000002000000020000000200000002022018020220190202202002022020020220190202202002022020020220200202202002022020020220200202202002022020020220200202202002022020020220200202202002022020020220200202202002022021020000000200000002021018020200200202002002020020020200200202401902022020020220200202202002022020020220200202202002022020020220200202202002022020020220200202202002022020020220200202202002022020020220210200000002000000020000000100400101004002010040010100300201003002
020070190200000002007019020000000200000002000000020000000200000002000000020000000200000002000000020000000200000002000000020000000200000002000000020000000200000002000000020000000200000002000000020000000200000002000000020000000200000002000000020000000200000002021018020200200202002002020020020200200202102102000000020000000200000002000000020000000200000002000000020000000200000002000000020000000200000002000000020000000200000002000000020000000200000002000000020000000100400101004002010040010100300201003002
020070190200000002007019020000000200000002000000020000000200000002000000020000000200000002000000020000000200000002000000020000000200000002000000020000000200000002000000020000000200000002000000020000000200000002000000020000000200000002000000020000000200000002021018020200200202002002020020020200200202102102000000020000000200000002000000020000000200000002000000020000000200000002000000020000000200000002000000020000000200000002000000020000000200000002000000020000000100400101004002010040010100400101003002
020070190200701902007019020000000200000002000000020000000200000002000000020000000200000002000000020000000200000002000000020000000200000002000000020000000200000002000000020000000200000002000000020000000200000002000000020000000200000002000000020000000200000002021018020200200202002002020020020200200202102102000000020000000200000002000000020000000200000002000000020000000200000002000000020000000200000002000000020000000200701902007019020070190200000002000000020000000100400101004002010040010100400101003002
020070190200701902007019020070190200701902007019020070190200701902007019020070190200701902007019020070190200701902007019020070190200701902007019020070190200701902007019020070190200701902007019020070190200701902007019020070190200701902007019020070190200000002021018020200200202002002020020020200200202102102007019020070190200701902007019020070190200701902007019020070190200701902007019020070190200701902007019020070190200701902007019020070190200701902007019020000000100400101004002010040010100400101003002
020070190200000002000000020000000200000002000000020000000200000002000000020000000200000002000000020000000200000002000000020000000200000002000000020000000200000002000000020000000200000002000000020000000200000002000000020000000200000002007019020070190200000002021018020200200202002002020020020200200202102102007019020070190200701902007019020070190200701902007019020070190200701902007019090010060200701902007019020070190200701902007019020070190200701902007019020000000100400101004002010040010100400101003002
020070190200701902007019020070190200701902007019020070190200701902007019020070190200701902007019020070190200701902007019020070190200701902007019020070190200701902007019020070190200701902007019020070190200701902007019020070190200701902000000020070190200000002021018020200200202002002020020020200200202102102007019020070190200701902007019020070190200701902007019020070190200701902007019020070190200701902007019020070190200701902007019020070190200701902007019020000000100400101004002010040010100400101003002
020000000200000002000000020000000200000002000000020000000200000002000000020000000200000002000000020000000200000002000000020000000200000002000000020000000200000002000000020000000200000002000000020000000200000002000000020000000200000002000000020000000200000002021018020200200202002002020020020200200202102102000000020000000200000002000000020000000200000002000000020000000200000002000000020000000200000002000000020000000200000002000000020000000200701902007019020000000100400101004002010040010100400101003002
