63
51
100000000000000000000000000000000000000011000000000000000010000
100000000000000000000000000000000000000011000000000000000010000
100000000000000000000000000000000000000011111111111111111010000
100000000000000000000000000000000000000011111111111111111010000
000111111111111111111111111111100000000011111111111111111110000
000111111111111111111111111111100000000011111111111111111110000
011110000000000000000000000000000000000000000000000000000010000
011110000000000000000000000000000000000000000000000000000010000
011110000000000000000000000000000000000000000000000000000010000
011110000000000000000000000000000000000000000000000000000010000
011110000000000000000000000000000000000011110111101111000010000
011110000011110111101111011110000000000011110111101111000010000
011110000011110111101111011110000000000010110101101011000010000
011110000010110101101011010110000000000000000000000000000010000
011110000000000000000000000000000000000000000000000000000010000
011110000000000000000000000000000000000000000000000000000010000
011110000000000000000000000000000000000000000000000000000010000
011110000000000000000000000000000000000000111101111000000010100
011110000000000000000000000000000000000000111101111000000010111
011110000000111011111110111110000000000000111101111000000010111
011110000011111111111110111110000000000000111101111000000010000
011110000011111111110110111110000000000000000000000000000010000
111110000011011111010100110110000000000000000000000000000011111
111110000001000100000000100010000000000000000000000000000010000
000000000000000000000000000000000000000000000000000000000000000
000000000000000000000000000000001111110000000000000000000000000
000000000000000000000000000000001111110000000000000000000000000
000000000000000000000000000000011111110000000000000000000000000
000000000000000000000000001110011111110011100000100000000011111
000000000000000000010001011111011111110111110001110000000011111
000000000001110111011011011111011111110111110011111000000010110
000000000001110111011011010111011101110101110010111000000010100
000000000000010100000000000001000000000100000000001000000010100
000000000000000000000000000000000000000000000000000000000010100
000000000000000000000000000000000000000000000000000000000010100
110000000000000000000000000000000000000000000000000000000010100
110000000000000000000000000000000000000000000000000000000010100
110000000000000000000000000000000000000000000000000000000010100
110000000011110111101111011110000000000011110111101111000010100
110000000011110111101111011110000000000011110111101111000010100
110000000010110101101011010110000000000010110101101011000010100
110000000000000000000000000000000000000000000000000001000010100
110000000000000000000000000000000000000000000000000000000010100
110000000000000000000000000000000000000000000000000000000010111
110000000000000000000000000000000000000000000000000000000010111
110000000000000000000000000000000000000000000000000000000010111
110000000000000000000000000000000000000000000000000000000010111
110000000000000000000000000000000000000000000000000000000010111
110000000000000000000000000000000000000000000000000000000010111
111111111111111111111111111111000000000011111111111111110010111
111111111111111111111111111111000000000000011111111111110010111
