60
20
011111111110000000000000000000000000000111111111000000100000
011111111110000000000000000000000000000111111111000000100000
011000000000111111111111111111111111111000000000000000100000
011111111111111111111111111111111111111110000111110000111110
011111111111100000000000000000000000001111111111110000111100
010000000000001100000000000000000000000001111100000000000100
110000000000001100000000000000000000000000000000000000000100
110011000000001100000000000000000000000000000000000000000100
000000000000000000000000000000000000000000000000000000000100
000000000000000000000000000000001100000000000000000000000100
000000000000000000000011110000001100000000000000000000000100
000111111110001111000010110000001100000000000000000000000100
000111111110001111000010110000000000000000000000000000000100
111100000010001111000010010000000000000000000000000000000100
000000000010001111000010010000000000000000000000011111111100
000000000010001111000010010000000000000000000000010000000000
011111111010000000000010010000000000000000000000010111111111
010111101011111111111110011111111111111111111111110101111111
010111101000000000000000000000000000000000000000000101000000
010111101000000000000000000000000000000000000000000101000000
