60
20
020-10-101005001010050020100500201005002010050020100500201005002010050020100500201005003020-10-1020-10-1020-10-1020-10-1020-10-1020-10-1020-10-1020-10-1020-10-1020-10-1020-10-1020-10-1020-10-1020-10-1020-10-1020-10-1020-10-1020-10-1020-10-1020-10-1020-10-1020-10-1020-10-1020-10-1020-10-1020-10-1020-10-1020-10-1010050010100500201005002010050020100500201005002010050020100500201005003020-10-1020-10-1020-10-1020-10-1020-10-1020-10-101004001020-10-1020-10-1020-10-1020-10-1020-10-1
020-10-101006001010060020100600201006002010060020100600201006002010060020100600201006003020-10-1020-10-1020-10-1020-10-1020-10-1020-10-1020-10-1020-10-1020-10-1020-10-1020-10-1020-10-1020-10-1020-10-1020-10-1020-10-1020-10-1020-10-1020-10-1020-10-1020-10-1020-10-1020-10-1020-10-1020-10-1020-10-1020-10-1020-10-1010060010100600201006002010060020100600201006002010060020100600201006003020-10-1020-10-1020-10-1020-10-1020-10-1020-10-101004001020-10-1020-10-1020-10-1020-10-1020-10-1
020-10-10100400301004001020-10-1020-10-1020-10-1020-10-1020-10-1020-10-1020-10-1020-10-1020-10-1010030020100500201005002010050020100500201005002010050020100500201005002010050020100500201005002010050020100500201005002010050020100500201005002010050020100500201005002010050020100500201005002010050020100500201005002020-10-1020-10-1020-10-1020-10-1020-10-1020-10-1020-10-1020-10-1020-10-1020-10-1020-10-1020-10-1020-10-1020-10-1020-10-101004001020-10-1020-10-1020-10-1020-10-1020-10-1
020-10-101004003010050010100500201005002010050020100500201005002010050020100500201005002010050020100500201006002010060020100600201006002010060020100600201006002010060020100600201006002010060020100600201006002010060020100600201006002010060020100600201006002010060020100600201006002010060020100600201006002010050010100500201005002020-10-1020-10-1020-10-1020-10-10100500301005002010050020100500201005003020-10-1020-10-1020-10-1020-10-10100500101005002010050020100500201003002020-10-1
020-10-1010040030100600101006002010060020100600201006002010060020100600201006002010060020100600201006003010-10-1020-10-1020-10-1020-10-1020-10-1020-10-1020-10-1020-10-1020-10-1020-10-1020-10-1020-10-1020-10-1020-10-1020-10-1020-10-1020-10-1020-10-1020-10-1020-10-1020-10-1020-10-1020-10-1020-10-1020-10-1010060010100600201006002010050020100500201005002010050020100500301006002010060020100600201006003020-10-1020-10-1020-10-1020-10-101006001010060020100600201005001020-10-1020-10-1
020-10-101004003020-10-1020-10-1020-10-1020-10-1020-10-1020-10-1020-10-1020-10-1020-10-1020-10-1020-10-1020-10-10100401601004017020-10-1020-10-1020-10-1020-10-1020-10-1020-10-1020-10-1020-10-1020-10-1020-10-1020-10-1020-10-1020-10-1020-10-1020-10-1020-10-1020-10-1020-10-1020-10-1020-10-1020-10-1020-10-1020-10-1020-10-1020-10-10100600101006002010060020100600201006003020-10-1020-10-1020-10-1020-10-1020-10-1020-10-1020-10-1020-10-1020-10-1020-10-1020-10-101005001020-10-1020-10-1
0100500201005003020-10-1020-10-1020-10-1020-10-1020-10-1020-10-1020-10-1020-10-1020-10-1020-10-1020-10-1020-10-10100501601005017020-10-1020-10-1020-10-1020-10-1020-10-1020-10-1020-10-1020-10-1020-10-1020-10-1020-10-1020-10-1020-10-1020-10-1020-10-1020-10-1020-10-1020-10-1020-10-1020-10-1020-10-1020-10-1020-10-1020-10-1020-10-1020-10-1020-10-1020-10-1020-10-1020-10-1020-10-1020-10-1020-10-1020-10-1020-10-1020-10-1020-10-1020-10-1020-10-1020-10-1020-10-101004001020-10-1020-10-1
0100600201006003020-10-1020-10-10700301607003017020-10-1020-10-1020-10-1020-10-1020-10-1020-10-1020-10-1020-10-10100601601006017020-10-1020-10-1020-10-1020-10-1020-10-1020-10-1020-10-1020-10-1020-10-1020-10-1020-10-1020-10-1020-10-1020-10-1020-10-1020-10-1020-10-1020-10-1020-10-1020-10-1020-10-1020-10-1020-10-1020-10-1020-10-1020-10-1020-10-1020-10-1020-10-1020-10-1020-10-1020-10-1020-10-1020-10-1020-10-1020-10-1020-10-1020-10-1020-10-1020-10-1020-10-101004001020-10-1020-10-1
020-10-1020-10-1020-10-1020-10-1020-10-1020-10-1020-10-1020-10-1020-10-1020-10-1020-10-1020-10-1020-10-1020-10-1020-10-1020-10-1020-10-1020-10-1020-10-1020-10-1020-10-1020-10-1020-10-1020-10-1020-10-1020-10-1020-10-1020-10-1020-10-1020-10-1020-10-1020-10-1020-10-1020-10-1020-10-1020-10-1020-10-1020-10-1020-10-1020-10-1020-10-1020-10-1020-10-1020-10-1020-10-1020-10-1020-10-1020-10-1020-10-1020-10-1020-10-1020-10-1020-10-1020-10-1020-10-1020-10-1020-10-101004001020-10-1020-10-1
020-10-1020-10-1020-10-1020-10-1020-10-1020-10-1020-10-1020-10-1020-10-1020-10-1020-10-1020-10-1020-10-1020-10-1020-10-1020-10-1020-10-1020-10-1020-10-1020-10-1020-10-1020-10-1020-10-1020-10-1020-10-1020-10-1020-10-1020-10-1020-10-1020-10-1020-10-1020-10-10100401601004017020-10-1020-10-1020-10-1020-10-1020-10-1020-10-1020-10-1020-10-1020-10-1020-10-1020-10-1020-10-1020-10-1020-10-1020-10-1020-10-1020-10-1020-10-1020-10-1020-10-1020-10-1020-10-1020-10-101004001020-10-1020-10-1
020-10-1020-10-1020-10-1020-10-1020-10-1020-10-1020-10-1020-10-1020-10-1020-10-1020-10-1020-10-1020-10-1020-10-1020-10-1020-10-1020-10-1020-10-1020-10-1020-10-1020-10-1020-10-101002001010020020100200201002003020-10-1020-10-1020-10-1020-10-1020-10-1020-10-10100501601005017020-10-1020-10-1020-10-1020-10-1020-10-1020-10-1020-10-1020-10-1020-10-1020-10-1020-10-1020-10-1020-10-1020-10-1020-10-1020-10-1020-10-1020-10-1020-10-1020-10-1020-10-1020-10-1020-10-101004001020-10-1020-10-1
020-10-1020-10-1020-10-10100200101002002010020020100200201002002010020020100200201002003020-10-1020-10-1020-10-101002001010020020100200201002003020-10-1020-10-1020-10-1020-10-101003001020-10-10100300201003003020-10-1020-10-1020-10-1020-10-1020-10-1020-10-10100601601006017020-10-1020-10-1020-10-1020-10-1020-10-1020-10-1020-10-1020-10-1020-10-1020-10-1020-10-1020-10-1020-10-1020-10-1020-10-1020-10-1020-10-1020-10-1020-10-1020-10-1020-10-1020-10-1020-10-101004001020-10-1020-10-1
010-10-1010-10-1010-10-10100300101003002010030020100300201003002010030020100300201003003020-10-1020-10-1020-10-101003001010030020100300201003003020-10-1020-10-1020-10-1020-10-101004001020-10-10100300201004003020-10-1020-10-1020-10-1020-10-1020-10-1020-10-1020-10-1020-10-1020-10-1020-10-1020-10-1020-10-1020-10-1020-10-1020-10-1020-10-1020-10-1020-10-1020-10-1020-10-1020-10-1020-10-1020-10-1020-10-1020-10-1020-10-1020-10-1020-10-1020-10-1020-10-1020-10-101005001020-10-1020-10-1
01002002010020020100200201002005020-10-1020-10-1020-10-1020-10-1020-10-1020-10-101004003020-10-1020-10-1020-10-101004001010040020100300201004003020-10-1020-10-1020-10-1020-10-101004001020-10-1020-10-101004003020-10-1020-10-1020-10-1020-10-1020-10-1020-10-1020-10-1020-10-1020-10-1020-10-1020-10-1020-10-1020-10-1020-10-1020-10-1020-10-1020-10-1020-10-1020-10-1020-10-1020-10-1020-10-1020-10-1020-10-1020-10-1020-10-1020-10-1020-10-1020-10-1020-10-1020-10-101005001020-10-1020-10-1
020-10-1020-10-1020-10-1020-10-1020-10-1020-10-1020-10-1020-10-1020-10-1020-10-101004003020-10-1020-10-1020-10-101005001010050020100500201005003020-10-1020-10-1020-10-1020-10-101004001020-10-1020-10-101004003020-10-1020-10-1020-10-1020-10-1020-10-1020-10-1020-10-1020-10-1020-10-1020-10-1020-10-1020-10-1020-10-1020-10-1020-10-1020-10-1020-10-1020-10-1020-10-1020-10-1020-10-1020-10-1010-10-1010020010100200201002002010020020100200201002002010020020100200201002005020-10-1020-10-1
020-10-1020-10-1020-10-1020-10-1020-10-1020-10-1020-10-1020-10-1020-10-1020-10-101004003020-10-1020-10-1020-10-101006001010060020100600201006003020-10-1020-10-1020-10-1020-10-101004001020-10-1020-10-101004003020-10-1020-10-1020-10-1020-10-1020-10-1020-10-1020-10-1020-10-1020-10-1020-10-1020-10-1020-10-1020-10-1020-10-1020-10-1020-10-1020-10-1020-10-1020-10-1020-10-1020-10-1020-10-1020-10-101003001020-10-1020-10-1020-10-1020-10-1020-10-1020-10-1020-10-1020-10-1020-10-1020-10-1
020-10-10100200701002012010020120100201201002012010020120100201201002009020-10-101004003020-10-1020-10-1020-10-1020-10-1020-10-1020-10-1020-10-1020-10-1020-10-1020-10-1020-10-101004001020-10-1020-10-101004003020-10-1020-10-1020-10-1020-10-1020-10-1020-10-1020-10-1020-10-1020-10-1020-10-1020-10-1020-10-1020-10-1020-10-1020-10-1020-10-1020-10-1020-10-1020-10-1020-10-1020-10-1020-10-1020-10-101004001020-10-1010020070100200801002008010020080100200801002008010020080100200801002008
020-10-101004001020-10-101002007010020080100200801002009020-10-101004003020-10-101002004010020020100200201002002010020020100200201002002010020020100200201002002010020020100200201002005020-10-1020-10-101002004010020020100200201002002010020020100200201002002010020020100200201002002010020020100200201002002010020020100200201002002010020020100200201002002010020020100200201002002010020020100200201002005020-10-101004001020-10-101002007010020120100201201002012010020120100201201002012
020-10-101004001020-10-101005001010050020100500201005003020-10-101004003020-10-1020-10-1020-10-1020-10-1020-10-1020-10-1020-10-1020-10-1020-10-1020-10-1020-10-1020-10-1020-10-1020-10-1020-10-1020-10-1020-10-1020-10-1020-10-1020-10-1020-10-1020-10-1020-10-1020-10-1020-10-1020-10-1020-10-1020-10-1020-10-1020-10-1020-10-1020-10-1020-10-1020-10-1020-10-1020-10-1020-10-1020-10-1020-10-1020-10-1020-10-1020-10-101004001020-10-101004001020-10-1020-10-1020-10-1020-10-1020-10-1020-10-1
020-10-101004001020-10-101006001010060020100600201006003020-10-101004003020-10-1020-10-1020-10-1020-10-1020-10-1020-10-1020-10-1020-10-1020-10-1020-10-1020-10-1020-10-1020-10-1020-10-1020-10-1020-10-1020-10-1020-10-1020-10-1020-10-1020-10-1020-10-1020-10-1020-10-1020-10-1020-10-1020-10-1020-10-1020-10-1020-10-1020-10-1020-10-1020-10-1020-10-1020-10-1020-10-1020-10-1020-10-1020-10-1020-10-1020-10-1020-10-101004001020-10-101004001020-10-1020-10-1020-10-1020-10-1020-10-1020-10-1
