60
20
010030020100300201003002010030020100300201003002010030020100300201003002010030020100300201003002010030020100300201003002010030020100300201003002010030020100300201003002010030020100300201003002010030020100300201003002010030020100300201003002010030020100300201003002010030020100300201003002010030020100300201003002010030020100300201003002010030020100300201003002010030020100300201003002010030020100400302000000020000000200000002000000010040010100300201003002010030020100300201003002
010030020100300301003002010030020100300201003002010030020100300201003002010030020100300201003002010030020100300201003002010030020100300201003002010030020100300201003002010030020100300201003002010030020100300201003002010030020100300201003002010030020100300201003002010030020100300201003002010030020100300201003002010030020100300201003002010030020100300201003002010030020100300201003002010030020100400302000000020000000200000002000000010040010100300201003002010030020100300201003002
010040020100400201004002010040020100400201004002010040020100400201004002010040020100400201004002010040020100400201004002010040020100400201004002010040020100400201004002010040020100400201004002010040020100400201004002010040020100400201004002010040020100400201004002010040020100400201004002010040020100400201006001010040020100400201004002010040020100400201004002010040020100400201004002010040020100400302000000020000000200000002000000010040010100400201004002010040020100400201003002
010030020200000002000000010040020100400201004002010040020100400201004002010040020100400201004002010040020200000002000000020000000200000002000000020000000200000002000000020000000200000002000000020000000200000002000000020000000200000002000000020000000200000002000000020000000200000002000000020000000200000001004002010040020100400201004002010040020100400201004002010040020100400201004002010040020100500302000000020000000200000002000000010050010200000002000000020000000100300201003002
010030020200000002000000020000000200000002000000020000000200000002000000020000000200000002000000020000000200000002000000020000000200000002000000020000000200000002000000020000000200000002000000020000000200000002000000020000000200000002000000020000000200000002000000020000000200000002018009020180100201801202000000020000000100400201004002010040020100400201004002010040020200000002000000020000000200000002000000020000000200000002000000020000000100600202000000010030020100300201003002
010030020200000002000000020000000200000002000000020000000200000002000000020000000200000002000000020000000200000002000000020000000200000002000000020000000200000002000000020000000200000002000000020000000200000002000000020000000200000002000000020000000200000002000000020000000200000002019009020190110202201002018010020180100201801202000000020000000200000002000000020000000200000002000000020000000200000002000000020000000200000002000000020000000200000002000000020000000100300201003002
010030020200000002000000020000000200000002000000020000000200000002000000020000000200000002000000020000000200000002000000020000000200000002000000020000000200000002000000020000000200000002000000020000000200000002000000020000000200000002000000020000000200000002000000020000000200000002020009020190110201901102019011020190110201901202000000020000000200000002000000020000000200000002000000020000000200000002000000020000000200000002000000020000000200000002000000020000000100300201003002
020000000200000002000000020000000200000002000000020000000200000002000000020000000200000002000000020000000200000002000000020000000200000002000000020000000200000002000000020000000200000002000000020000000200000002000000020000000200000002000000020000000200000002000000020000000201800902022009020230100202101102021011020210110202101202000000020000000200000002000000020000000200000002000000020000000200000002000000020000000200000002000000020000000200000002000000020000000100300201003002
020000000200000002000000020000000200000002000000020000000200000002000000020000000200000002000000020000000200000002000000020000000200000002000000020000000200000002000000020000000200000002000000020000000200000002000000020000000200000002000000020000000200000002000000020000000202100902021011020210120200000002000000020000000200000002000000020000000200000002000000020000000200000002000000020000000200000002000000020000000200000002000000020000000200000002000000020000000100300201003002
020260290202602902026030020000000200000002000000020000000200000002000000020000000200000002000000020000000200000002000000020000000200000002000000020000000200000002000000020000000200000002000000020000000200000002000000020000000200000002000000020000000200000002000000020000000200000002000000020000000200000002000000020000000200000002000000020000000200000002000000020000000200000002000000020000000200000002000000020000000200000002000000020000000200000002000000020000000100300201003002
020270290202702902027030020000000200000002000000020000000200000002000000020000000200000002000000020000000200000002000000020000000200000002000000020000000200000002000000020000000200000002000000020000000200000002000000020000000200000002000000020000000200000002000000020000000200000002000000020000000200000002000000020000000200000002000000020000000200000002000000020000000200000002000000020000000200000002000000020000000200000002000000020000000200000002000000020000000100300201003002
020270290202702902027030020000000200000002000000020000000200000002000000020000000200000002000000020000000200000002000000020000000200000002000000020000000200000002000000020000000200000001003002010030020200000002000000020000000200000002000000020000000200000002000000020000000200000002000000020000000200000002000000020000000200000002000000020000000200000002000000020000000200000002000000020000000200000002000000020000000200000002000000020000000200000002000000020000000100300201003002
020290290202902902029030020000000200000002000000020000000200000002000000020000000200000002000000020000000200000002000000020000000200000002000000020000000200000002000000020000000100300201003002010030020200000002000000020180090201801202000000020000000200000002000000020000000200000002000000020000000200000002000000020000000200000002000000020000000200000002000000020000000200000002000000020000000200000002000000020000000200000002000000020000000200000002000000020000000100300201003002
020000000200000002000000020000000100300201003002010030020100300201003002010030020200000002000000020000000200000002000000020000000200000002000000020000000200000002000000020000000100300201003002010030020200000002007019020190090201901202007019020070190200000002000000020000000200000002000000020000000200000002000000020000000200000002000000020000000200000002000000020000000200000002000000020000000200000002000000020000000200000002000000020000000200000002000000020000000100300201003002
010040020100400201003002010030020100300201003002010030020100300201003002010030020200000002000000020000000200000002000000020000000200000002000000020000000200000002000000020000000100300201003002010030020200000002007019020190090202201002018012020180090201801102018012020000000200000002000000020000000200000002000000020000000200000002000000020000000201800902018010020180100201801002018012020000000200000002000000020000000200000002000000020000000200000002000000020000000100300201003002
010040020100400201004002010040020100400201004002010040020100400201004002010040020200000002000000020000000200000002000000020000000200000002000000020000000200000002000000020000000100300201003002010030020200000002007019020210090202300902022010020220090201901102020012020000000200000002000000020000000200000002000000020000000200000002000000020180090202200902019011020190110201901102019012020000000200000001003002010030020100300201003002010030020100300201003002010030020100300201003002
010040020100400201004002010040020100400201004002010040020100400201004002010040020200000002000000020000000200000002000000020000000200000002000000020000000200000002000000020000000100300201003002010030020200000002007019020070190202100902021011020210110202300902020012020000000200000002000000020000000200000002000000020000000200000002000000020210090202101002021011020210110202101102021012020000000100300201003002010030020100300201003002010030020100300201003002010030020100300201003002
010040020100400201004002010040020100400201004002010040020100400201004002010040020200000002000000020000000200000002000000020000000200000002000000020000000200000002000000020000000100300201003002010030020200000002000000020000000200000002000000020070190202100902021012020000000200000002000000020000000200000002000000020000000200000002000000020000000200000002000000020000000200000002000000020000000100300201003002010030020100300201003002010030020100300201003002010030020100300201003002
010030020100400201004002010040020100400201004002010040020100400201004002010040020100400201004002010040020100400201004002010040020100400201004002010040020100400201004002010040020100400201004002010040020100400201004002010040020100400201004002010040020100400201004002010040020100400201004002010040020100400201004002010040020100400201004002010040020100400201004002010040020100400201004002010040020100300201004002010040020100400201004002010040020100400201004002010040020100300201003002
010030020100300201003002010030020100300201003002010030020100300201003002010030020100300201003002010030020100300201003002010030020100300201003002010030020100300201003002010030020100300201003002010030020100300201003002010030020100300201003002010030020100300201003002010030020100300201003002010030020100300201003002010030020100300201003002010030020100300201003002010030020100300201003002010030020100300201003002010030020100300201003002010030020100300201003002010030020100300201003002
