47
40
020-10-1020-10-1020-10-1020-10-1020-10-1020-10-1020-10-1020-10-1020-10-1020-10-1020-10-1020-10-1020-10-1020-10-1020-10-1020-10-1020-10-1020-10-1020-10-1020-10-1020-10-1020-10-1020-10-1020-10-1020-10-1020-10-1020-10-1020-10-109005006090050070900500609005007090050060900500709005006090050070900500609005007090050060900500709005006090050070900500609005007090050060900500709005006
020-10-10900500609005007020-10-1020-10-10900500609005007090050060900500709005006090050070900500609005007090050060900500709005006090050070900500609005007020-10-1020-10-1020-10-1020-10-1020-10-1020-10-1020-10-1020-10-1020-10-109006006090060070900600609006007090060060900600709006006090060070900600609006007090060060900600709006006090060070900600609006007090060060900600709006006
020-10-10900600609006007020-10-1020-10-10900600609006007090060060900600709006006090060070900600609006007090060060900600709006006090060070900600609006007020-10-1020-10-1020-10-1020-10-1020-10-1020-10-1020-10-1020-10-1020-10-1020-10-1020-10-1020-10-1020-10-1020-10-1020-10-1020-10-1020-10-1020-10-1020-10-1020-10-1020-10-1020-10-1020-10-1020-10-1020-10-1020-10-1020-10-1020-10-1
020-10-10900500609005007090050060900500709005006090050070900500609005007090050060900500709005006090050070900500609005007090050060900500709005006090050070900500809005009020-10-1020-10-1020-10-1020-10-1020-10-1020-10-10900500509005006090050070900500609005007090050060900500709005006090050070900500609005007090050060900500709005006090050070900500609005007090050060900500709005006
020-10-10900600609006007090060060900600709006006090060070900600609006007090060060900600709006006090060070900600609006007090060060900600709006006090060070900600809006009020-10-1020-10-1020-10-1020-10-1020-10-1020-10-10900600509006006090060070900600609006007090060060900600709006006090060070900600609006007090060060900600709006006090060070900600609006007090050060900500709005006
020-10-109005006090050070900500809005009020-10-1020-10-1020-10-1020-10-1020-10-1020-10-1020-10-1020-10-1020-10-1020-10-1020-10-1020-10-1020-10-1020-10-1020-10-1020-10-1020-10-1020-10-1020-10-1020-10-1020-10-1020-10-1020-10-1020-10-1020-10-1020-10-1020-10-1020-10-1020-10-1020-10-1020-10-1020-10-1020-10-1020-10-1020-10-1020-10-1020-10-1020-10-1020-10-1090060060900600709006006
020-10-109006006090060070900600809006009020-10-1020-10-1020-10-1020-10-1020-10-1020-10-1020-10-1020-10-1020-10-1020-10-1020-10-1020-10-1020-10-1020-10-1020-10-1020-10-1020-10-1020-10-1020-10-1020-10-1020-10-1020-10-1020-10-1020-10-1020-10-1020-10-1020-10-1020-10-1020-10-1020-10-1020-10-1020-10-1020-10-1020-10-1020-10-1020-10-1020-10-1020-10-1020-10-1090050060900500709005006
020-10-109005006090050070900500809005009020-10-1020-10-1020-10-1020-10-1020-10-1020-10-1020-10-1020-10-1020-10-1020-10-1020-10-1020-10-1020-10-1020-10-1020-10-1020-10-1020-10-1020-10-1020-10-1020-10-1020-10-1020-10-1020-10-1020-10-1020-10-1020-10-1020-10-1020-10-1020-10-1020-10-1020-10-1020-10-1020-10-1020-10-1020-10-1020-10-1020-10-1020-10-1020-10-1090060060900600709006006
020-10-109006006090060070900600809006009020-10-1020-10-1020-10-1020-10-1020-10-1020-10-1020-10-1020-10-1020-10-1020-10-1020-10-1020-10-1020-10-1020-10-1020-10-1020-10-1020-10-1020-10-1020-10-1020-10-1020-10-1020-10-1020-10-1020-10-1020-10-1020-10-1020-10-1020-10-1020-10-1020-10-1020-10-1020-10-1020-10-1020-10-1020-10-1020-10-1020-10-1020-10-1020-10-1090050060900500709005006
020-10-109005006090050070900500809005009020-10-1020-10-1020-10-1020-10-1020-10-1020-10-1020-10-1020-10-1020-10-1020-10-1020-10-1020-10-1020-10-1020-10-1020-10-1020-10-1020-10-1020-10-1020-10-1020-10-1020-10-1020-10-1020-10-1020-10-1020-10-1020-10-1020-10-1020-10-1020-10-1020-10-1020-10-1020-10-1020-10-1020-10-1020-10-1020-10-1020-10-1020-10-1020-10-1090060060900600709006006
020-10-109006006090060070900600809006009020-10-1020-10-1020-10-1020-10-1020-10-1020-10-1020-10-1020-10-1020-10-1020-10-1020-10-1020-10-1020-10-1020-10-1020-10-1020-10-1020-10-1020-10-1020-10-1020-10-1020-10-1020-10-1020-10-1020-10-1020-10-1020-10-1020-10-1020-10-1020-10-1020-10-1020-10-1020-10-1020-10-1020-10-1020-10-1020-10-1020-10-1020-10-1020-10-1090050060900500709005006
020-10-109005006090050070900500809005009020-10-1020-10-1020-10-1020-10-1020-10-1020-10-1020-10-1020-10-1020-10-1020-10-1020-10-1020-10-1020-10-1020-10-1020-10-1020-10-1020-10-1020-10-1020-10-1020-10-1020-10-1020-10-1020-10-1020-10-1020-10-1020-10-1020-10-1020-10-1020-10-1020-10-1020-10-1020-10-1020-10-1020-10-1020-10-1020-10-1020-10-1020-10-1020-10-1090060060900600709006006
020-10-109006006090060070900600809006009020-10-1020-10-1020-10-1020-10-1020-10-1020-10-1020-10-1020-10-1020-10-1020-10-1020-10-1020-10-1020-10-1020-10-1020-10-1020-10-1020-10-1020-10-1020-10-1020-10-1020-10-1020-10-1020-10-1020-10-1020-10-1020-10-1020-10-1020-10-1020-10-1020-10-1020-10-1020-10-1020-10-1020-10-1020-10-1020-10-1020-10-1020-10-1020-10-1090050060900500709005006
020-10-109005006090050070900500809005009020-10-1020-10-1020-10-1020-10-1020-10-1020-10-1020-10-1020-10-1020-10-1020-10-1020-10-1020-10-1020-10-1020-10-1020-10-1020-10-1020-10-1020-10-1020-10-1020-10-1020-10-1020-10-1020-10-1020-10-1020-10-1020-10-1020-10-1020-10-1020-10-1020-10-1020-10-1020-10-1020-10-1020-10-1020-10-1020-10-1020-10-1020-10-1020-10-1090060060900600709006006
020-10-109006006090060070900600809006009020-10-1020-10-1020-10-1020-10-10900500509005006090050070900500809005009020-10-1020-10-1020-10-1020-10-1020-10-1020-10-1020-10-1020-10-100023028000230290002303000023031020-10-1020-10-1020-10-1020-10-1020-10-1020-10-10006105800061059000610600006106100061062020-10-1020-10-1020-10-1020-10-1020-10-1020-10-1020-10-1090050060900500709005006
020-10-109005006090050070900500809005009020-10-1020-10-1020-10-1020-10-10900600509006006090060070900600809006009020-10-1020-10-1020-10-1020-10-1020-10-1020-10-1020-10-1020-10-100024028020-10-10002403000024031020-10-1020-10-1020-10-1020-10-1020-10-1020-10-10006205800062059000620600006206100062062020-10-1020-10-1020-10-1020-10-1020-10-1020-10-1020-10-1090060060900600709006006
020-10-109006006090060070900600809006009020-10-1020-10-1020-10-1020-10-1020-10-109005006090050070900500809005009020-10-1020-10-1020-10-1020-10-1020-10-1020-10-1020-10-1020-10-1020-10-1020-10-1020-10-1020-10-1020-10-1020-10-1020-10-1020-10-1020-10-1020-10-10006305800063059020-10-10006306100063062020-10-1020-10-1020-10-1020-10-1020-10-1020-10-1020-10-1090050060900500709005006
020-10-109005006090050070900500809005009020-10-1020-10-1020-10-1020-10-1020-10-109006006090060070900600809006009020-10-1020-10-1020-10-1020-10-1020-10-1020-10-1020-10-1020-10-1020-10-1020-10-1020-10-1020-10-1020-10-1020-10-1020-10-1020-10-1020-10-1020-10-1020-10-1020-10-1020-10-1020-10-1020-10-1020-10-1020-10-1020-10-1020-10-1020-10-1020-10-1020-10-1090060060900600709006006
020-10-109006006090060070900600809006009020-10-1020-10-109005005090050060900500709005006090050070900500809005009020-10-1020-10-1020-10-1020-10-1020-10-1020-10-1020-10-1020-10-1020-10-1020-10-1020-10-1020-10-1020-10-1020-10-1020-10-1020-10-1020-10-1020-10-1020-10-1020-10-1020-10-1020-10-1020-10-1020-10-1020-10-1020-10-1020-10-1020-10-1020-10-1020-10-1020-10-1020-10-1020-10-1
020-10-109005006090050070900500809005009020-10-1020-10-109006005090060060900600709006006090060070900600809006009020-10-1020-10-1020-10-1020-10-1020-10-1020-10-1020-10-1020-10-1020-10-1020-10-1020-10-1020-10-1020-10-1020-10-1020-10-1020-10-1020-10-1020-10-1020-10-1020-10-1020-10-1020-10-1020-10-1020-10-1020-10-1020-10-1020-10-1020-10-1020-10-1020-10-1020-10-1020-10-1020-10-1
020-10-109006006090060070900600809006009020-10-1020-10-109005005090050060900500709005006090050070900500809005009020-10-1020-10-1020-10-102008007020080070200800702008007020-10-1020-10-1020-10-1020-10-1020-10-1020-10-1020-10-1020-10-1020-10-1020-10-1020-10-1020-10-1020-10-1020-10-1020-10-1020-10-1020-10-1020-10-1020-10-1020-10-1020-10-1020-10-1020-10-1090050060900500709005006
020-10-109005006090050070900500809005009020-10-1020-10-109006005090060060900600709006006090060070900600809006009020-10-1020-10-1020-10-102008007020080070200800702008007020-10-1020-10-1020-10-1020-10-1020-10-1020-10-1020-10-1020-10-1020-10-1020-10-1020-10-1020-10-1020-10-1020-10-1020-10-1020-10-1020-10-1020-10-1020-10-1020-10-1020-10-1020-10-1020-10-1090060060900600709006006
020-10-109006006090060070900600809006009020-10-1020-10-1020-10-1000-10-1000-10-1020-10-1020-10-1020-10-1020-10-1020-10-1020-10-1020-10-102008007020080070200800702008007020-10-1020-10-1020-10-1020-10-1020-10-1020-10-1020-10-1020-10-1020-10-1020-10-1020-10-1020-10-1020-10-1020-10-1020-10-1020-10-1020-10-1020-10-1020-10-1020-10-1020-10-1020-10-1020-10-1090050060900500709005006
020-10-109005006090050070900500809005009020-10-1020-10-1020-10-1000-10-1000-10-1020-10-1020-10-1020-10-1020-10-1020-10-1020-10-1020-10-102008007020080070200800702008007020-10-1020-10-1020-10-1000200150002001600020017020-10-1020-10-1020-10-1020-10-1020-10-1020-10-1000090220000902300009024020-10-1020-10-1020-10-1020-10-1020-10-1020-10-1020-10-1020-10-1090060060900600709006006
020-10-109006006090060070900600809006009020-10-1020-10-1020-10-10900500509005006090050070900500809005009020-10-1020-10-1020-10-1020-10-1020-10-1020-10-1020-10-1020-10-1020-10-1020-10-10002101400021015000210160002101700021018020-10-1020-10-1020-10-1020-10-10001002100010022000100230001002400010025020-10-1020-10-1020-10-1020-10-1020-10-1020-10-1020-10-1090050060900500709005006
020-10-109005006090050070900500809005009020-10-1020-10-1020-10-10900600509006006090060070900600809006009020-10-1020-10-1020-10-1020-10-1020-10-1020-10-1020-10-1020-10-1020-10-1020-10-10002201400022015000220160002201700022018020-10-1020-10-1020-10-1020-10-10001102100011022000110230001102400011025020-10-1020-10-1020-10-1020-10-1020-10-1020-10-1020-10-1090060060900600709006006
020-10-109006006090060070900600809006009020-10-1020-10-1020-10-10900500509005006090050070900500809005009020-10-1020-10-1020-10-1020-10-1020-10-1020-10-1020-10-1020-10-1020-10-10202800200023014020-10-1000230160002301700023018020-10-1020-10-1020-10-1020-10-100012021020-10-1000120230001202400012025020-10-1020-10-1020-10-1020-10-1020-10-1020-10-1020-10-1090050060900500709005006
020-10-109005006090050070900500809005009020-10-1020-10-1020-10-10900600509006006090060070900600809006009020-10-1020-10-1020-10-1020-10-1020-10-1020-10-1020-10-1020-10-1020-10-1020-10-1020-10-1020-10-1020-10-1020-10-1020-10-1020-10-1020-10-1020-10-1020-10-1020-10-1020-10-1020-10-1020-10-1020-10-1020-10-1020-10-10900500809005009020-10-1020-10-1020-10-1090060060900600709006006
020-10-109006006090060070900600809006009020-10-1020-10-1020-10-10900500509005006090050070900500809005009020-10-1020-10-1020-10-1020-10-1020-10-1020-10-1020-10-1020-10-1020-10-1020-10-1020-10-1020-10-1020-10-1020-10-1020-10-1020-10-1020-10-1020-10-1020-10-1020-10-1020-10-1020-10-1020-10-1020-10-1020-10-1020-10-10900600809006009020-10-1020-10-1020-10-1090050060900500709005006
020-10-109005006090050070900500809005009020-10-1020-10-1000-10-10900600509006006090060070900600809006009020-10-1020-10-1020-10-1020-10-1020-10-1020-10-1020-10-1020-10-1020-10-1020-10-1020-10-1020-10-1020-10-1020-10-1020-10-1020-10-1020-10-1020-10-1020-10-1020-10-1020-10-1020-10-1020-10-1020-10-1020-10-1020-10-10900500809005009020-10-1020-10-1020-10-1090060060900600709006006
020-10-109006006090060070900600809006009020-10-1020-10-1020-10-10900500509005006090050070900500809005009020-10-1020-10-1020-10-1020-10-1020-10-1020-10-1020-10-1020-10-1020-10-1020-10-1020-10-1020-10-1020-10-1020-10-1020-10-1020-10-1020-10-1020-10-10900100609001007020-10-1020-10-1020-10-1020-10-1020-10-1020-10-10900600809006009020-10-1020-10-1020-10-1090050060900500709005006
020-10-109005006090050070900500809005009020-10-1020-10-1020-10-10900600509006006090060070900600809006009020-10-1020-10-1020-10-1020-10-1020-10-1020-10-1020-10-1020-10-1020-10-1020-10-1020-10-1020-10-1020-10-1020-10-1020-10-1020-10-1090050060900500709005006090050070900500609005007090050060900500709005006090050070900500809005009020-10-1020-10-1020-10-1090060060900600709006006
020-10-109006006090060070900600809006009020-10-1020-10-1020-10-1020-10-1020-10-1020-10-1020-10-1020-10-1020-10-1020-10-1020-10-1020-10-1020-10-1020-10-1020-10-1020-10-1020-10-1020-10-1020-10-1020-10-1020-10-1020-10-1020-10-1020-10-1090060060900600709006006090060070900600609006007090060060900600709006006090060070900600809006009020-10-1020-10-1020-10-1090050060900500709005006
020-10-10900500609005007020-10-1020-10-1020-10-1020-10-1020-10-1020-10-1020-10-1020-10-1020-10-1020-10-1020-10-1020-10-1020-10-1020-10-1020-10-1020-10-1020-10-1020-10-1020-10-1020-10-1020-10-1020-10-1020-10-1020-10-1020-10-1020-10-10900500609005007020-10-1020-10-1020-10-1020-10-1020-10-1020-10-1020-10-1020-10-1020-10-1020-10-1020-10-1020-10-1020-10-1090060060900600709006006
020-10-10900600609006007020-10-1020-10-1020-10-1020-10-1020-10-1020-10-1020-10-1020-10-1020-10-1020-10-1020-10-1020-10-1020-10-1020-10-1020-10-1020-10-1020-10-1020-10-1020-10-1020-10-1020-10-1020-10-1020-10-1020-10-1020-10-1020-10-10900600609006007020-10-1020-10-1020-10-1020-10-1020-10-1020-10-1020-10-1020-10-1020-10-1020-10-1020-10-1020-10-1020-10-1090050060900500709005006
020-10-1090050060900500709005006090050070900500609005007090050060900500709005006090050070900500609005007020-10-1020-10-1020-10-1020-10-1020-10-1020-10-1020-10-1020-10-1020-10-1020-10-1020-10-1020-10-1020-10-1020-10-1020-10-1020-10-10900500609005007020-10-1020-10-1020-10-1020-10-1000-10-1000-10-1000-10-1000-10-1000-10-1000-10-1000-10-1000-10-109000007090060060900600709006006
020-10-1090060060900600709006006090060070900600609006007090060060900600709006006090060070900600609006007020-10-1020-10-1020-10-1020-10-1020-10-1020-10-1020-10-1020-10-1020-10-1020-10-1020-10-1020-10-1020-10-1020-10-1020-10-1020-10-10900600609006007020-10-1020-10-1020-10-1020-10-1000-10-10900500609005007090050060900500709005006090050070900500609005007090050060900500709005006
020-10-1090050060900500709005006090050070900500609005007090050060900500709005006090050070900500609005007020-10-1020-10-1020-10-1020-10-1020-10-1020-10-1020-10-1020-10-1020-10-1020-10-1020-10-1020-10-1020-10-1020-10-1020-10-1020-10-10900500609005007020-10-1020-10-1020-10-1020-10-1000-10-10900600609006007090060060900600709006006090060070900600609006007090060060900600709006006
020-10-1090060060900600709006006090060070900600609006007090060060900600709006006090060070900600609006007020-10-1020-10-1020-10-1020-10-1020-10-1020-10-1020-10-1020-10-1020-10-1020-10-1020-10-1020-10-1020-10-1020-10-1020-10-1020-10-10900600609006007020-10-1020-10-1020-10-1020-10-1000-10-10900500609005007090050060900500709005006090050070900500609005007090050060900500709005006
020-10-109005006090050070900500609005007090050060900500709005006090050070900500609005007090050060900500709005007020-10-1020-10-1020-10-1020-10-1020-10-1020-10-1020-10-1020-10-1020-10-1020-10-1020-10-1020-10-1020-10-1020-10-1020-10-10900500609005007020-10-1020-10-102027003020-10-1000-10-10900500609005007090050060900500709005006090050070900500609005007090050060900500709005006
