47
40
0200402802004028020040280200402802003029020030290200302902003029020030290200302902003029020030290200302902003029020030290200302902003029020030290200302902003029020030300200403102003032020030320200303202003032020030340200302702003028020030280200302802003028020030280200302802003028020030280200302802003028020030280200302802003028020030280200302802003028020030280200302802003028
0200402802004028020040280200402802003029020030290200302902003029020030290200302902003029020030290200302902003029020030290200302902003029020030290200302902003029020030300200403102003032020030320200303202003032020030340200302702003028020030280200302802003028020030280200302802003028020030280200302802003028020030280200302802003028020030280200302802003028020030280200302802003028
0200402802004028020040280200402802004028020030290200302902003029020030290200302902003029020030290200302902003029020030290200302902003029020030290200302902003029020030300200303102003032020030320200303202003032020030340200302702003028020030280200302802003028020030280200302802003028020030280200302802003028020030280200302802003028020030280200302802004029020030280200302802003028
0200302902003029020030290200302902007028020050290200502902005029020050290200502902005029020050290200502902005029020050290200502902005029020050290200502902005029020050300200303102003032020030320200303202003032020030340200502702005028020050280200502802005028020050280200502802005029020050290200502902005029020050290200502902005029020050290200702702004029020030280200302802003028
0200302902003029020030290200302902003030020440090200000002000000020000000200000002000000020000000200000002002031020020320200203302002033020020330200203302002033020020330200603102004032020040320200403202004032020060320200203202002032020020320200203202002032020020320200203202002032020020330200203302002034020070190200701902000000020000000200302702004029020030280200302802003028
0200302902003029020030290200302902003030020000000201800902018010020180100201801002018010020180120200000002003031020040320200403202004032020040320200403202004032020040320200403202004032020040320200403202004032020040320200403202004032020040320200403202004032020040320200403202004032020040320200403202003034020070190200701902044009020000000200302702004029020030280200302802003028
0200302902003029020030290200302902003030020000000201900902019010020230100202300902019011020190120200000002003031020040320200403202004032020040320200403202004032020040320200703202005032020050320200503202005032020070310200403202004032020040320200403202004032020040320200403202004032020040320200403202003034020070190204400902000000020000000200302702004029020030280200302802004029
0200302902003029020030290200302902003030020000000202000902019011020190120201900902019011020190120200000002003031020040320200403202004032020040320200403202004032020040330200403402000000020000000200000002000000020030310200403202004032020040320200403202004032020040320200403202004032020040320200403202003034020070190200701902000000020000000200302702004029020030280200302802004029
0200302902003029020030290200302902003030020000000202000902023010020210120202100902021011020210120200000002003031020040320200403202004032020040320200403202004032020040330200403402000000020000000200000002000000020030310200403202004032020040320200403202004032020040320200403202004032020040320200403202003034020070190200701902000000020000000200302702004029020030280200302802004029
0200302902003029020030290200302902003030020000000202000902020012020000000200000002000000020000000200000002003031020040320200403202004032020040320200403202004032020040330200403402000000020000000200000002000000020030310200403202004032020040320200403202004032020040320200403202004032020040320200403202003034020000000200701902000000020000000200302702004029020030280200302802004029
0200302902003029020030290200302902003030020000000202000902020012020000000200000002000000020000000200000002005031020050320200503202005032020050320200503202005032020050320200503402000000020000000200000002000000020050310200503302005033020050330200503302005033020050330200503302005033020050330200503302005034020000000200000002044009020000000200302702004029020030280200302802004029
0200302902003029020030290200302902003030020000000202100902021012020000000200000002000000020000000200000002000000020000000200000002000000020000000200000002000000020000000200000002000000020000000200000002000000020070190200000002000000020000000200000002000000020000000200000002000000020000000200000002000000020000000200000002000000020000000200302702004029020030280200302802004029
0200302902003029020030290200302902003030020000000200000002000000020000000200202702002028020020280200203002000000020260270202602802026028020260280202603002000000020000000202002702020028020200280202002802020028020200300200701902007019020070190200701902020027020200280202002802020028020200280202002802020030020070190201800902018011020180120200302702004029020030280200302802004029
0200302902003029020030290200302902003030020000000200000002044009020000000200302702004028020040280200303002000000020280270202702902027029020270290202703002000000020000000202102702021029020210290202102902021029020210300200701902007019020070190200701902021027020210280202102802021028020210280202102802022030020180090202200902019010020190120200302702004029020030280200302802004029
0200302902003029020030290200302902003030020000000200000002000000020000000200302702004028020040280200303002044009020280270202702902027029020270290202703002000000020000000202102702021029020210290202102902021029020210300200701902007019020070190200701902021027020210280202102802021028020210280202102802022030020200090201901002019010020190120200302702004029020030280200302802004029
0200302902003029020030290200302902003030020440090200000002000000020000000200302702004028020040280200303002000000020280270202702902027029020270290202703002000000020000000202102702021029020210290202102902021029020210300200701902007019020070190200701902021027020210280202102802021028020210280202102802022030020200090201901002019010020190120200302702004029020030280200402902004029
0200302902003029020030290200302902003030020000000200000002002027020020280200602702004028020040280200303002000000020280270202802902028029020270290202703002000000020000000202302702023028020230280202302802023028020230300200701902007019020070190200701902023027020230290202302902023029020230290202302902023030020210090202300902023010020210120200302702004029020030280200402902004029
0200302902003029020030290200302902003030020000000200000002004027020040280200402802004028020040280200303002000000020280270202802902027029020270290202703002000000020000000200000002000000020000000200000002000000020000000200000002000000020000000200000002000000020000000200000002000000020000000200000002000000020000000202000902022010020180120200302702004029020030280200402902004029
0200302902003029020030290200302902003030020000000200000002004027020040280200402802004028020040280200303002000000020280270202802902031028020290280202903002007019020070190202602702026029020260290202602902026029020260290202602902026029020260300200701902026027020260290202602902026029020260290202602902026030020000000202100902023009020200120200302702004029020030280200402902004029
0200302902003029020030290200302902003030020000000200000002004027020040280200402802004028020040280200303002000000020280270202802902027030020070190200701902007019020070190202702702028029020280290202802902028029020280290202802902028029020270300200701902027027020280290202802902028029020280290202802902027030020000000200000002021009020210120200302702004029020030280200402902004029
0200302902003029020030290200302902003030020000000200000002005027020050280200502802005029020050280200503002000000020280270202802902027030020070190200000002000000020070190202702702028029020280290202802902028029020280290202802902028029020270300200701902027027020280290202802902028029020280290202802902027030020000000200000002000000020000000200302702004029020030280200402902004029
0200302902003029020030290200302902003030020000000200000002000000020000000200000002000000020000000200000002000000020280270202802902027030020070190200000002000000020070190202702702028029020280290202802902028029020280290202802902028029020270300200701902027027020280290202802902028029020280290202802902027030020000000200000002000000020000000200302702004029020030280200402902004029
0200302902003029020030290200302902003030020000000204400902000000020000000200000002000000020000000200000002044009020280270202802902027030020070190200000002000000020070190202702702028029020280290202802902028029020280290202802902028029020270300200701902027027020280290202702902028029020280290202702902027030020000000200000002000000020000000200302702004029020030280200402902004029
0200302902003029020030290200302902003030020000000200000002002027020020280200202802002028020020280200203002000000020280270202702902027030020070190200701902007019020070190202802702028029020280290202702902027029020270290202702902028029020270300200701902027027020270290202702902027029020270290202802902027030020000000200000002000000020000000200302702004029020030280200402902004029
0200302902003029020030290200302902003030020000000200000002004027020040280200402802004028020040280200303002000000020280270202702902030028020260280202602902026029020260290203002702028029020270290202702902027029020270290202702902028029020270300200701902028027020270290202702902027029020270290202702902027030020000000200000002000000020000000200302702004029020030280200402902004029
0200302902003029020030290200302902003030020000000200000002004027020040280200402802004028020040280200303002000000020280270202702902027029020270290202702902027029020270290202802902028029020270290202702902027029020270290202702902028029020280300200701902028027020270290202702902027029020270290202702902027030020020270200202802002030020000000200302702004029020030280200402902004029
0200302902003029020030290200302902003030020000000200000002004027020040280200402802004028020040280200303002000000020280270202702902027029020270290202702902027029020270290202802902027029020270290202702902027029020270290202702902027029020280300200701902028027020270290202702902027029020270290202702902027030020040270200402902003030020000000200302702004029020030280200402902004029
0200302902003029020030290200302902003030020000000200000002004027020040280200402802004028020040280200303002000000020280270202802802028029020270290202702902027029020280290202802902027029020270290202702902027029020270290202702902027029020280300200701902028027020270290202702902027029020270280202702802027030020030270200402902003030020000000200302702004029020030280200402902004029
0200302902003029020030290200302902003030020000000200000002004027020040280200402802004028020040280200303002000000020290270202902802029028020290280202902802029028020290280203102702027029020270290202702902027029020310280202902902029029020290300200701902029027020290290202902902029029020290290202902902029030020030270200402902003030020000000200302702004029020030280200402902004029
0200302902003029020030290200302902003030020000000200000002004027020040280200402802004028020040280200303002000000020000000200000002000000020000000200000002000000020000000202702702027029020270290202702902027029020270300200000002000000020440090200000002000000020000000200000002000000020000000200000002007019020030270200402902003030020000000200302702004029020030280200402902004029
0200302902003029020030290200302902003030020000000200000002005027020050280200502802005028020050280200503002000000020000000200000002000000020000000204400902000000020000000202702702027029020270290202702902027029020270300200202702002028020020280200202802002028020020280200202802002028020020280200202802002028020060270200402902004030020000000200302702004029020030280200402902004029
0200302902003029020030290200302902003030020000000200000002000000020000000200000002000000020000000204400902000000020000000200000002000000020000000200000002000000020000000202702702027029020270290202702902027029020270300200402702004029020040290200402902004029020040290200402902004029020040290200302902004029020040290200402902004030020000000200302702004029020030280200402902004029
0200302902003029020030290200302902003030020000000200000002044009020000000200000002000000020000000200000002000000020000000200000002000000020000000200000002000000020000000202702702027029020270290202702902027029020270300200402702004029020040290200402902004029020070280200502902005029020050290200502902005029020050290200502902005030020000000200302702004029020030280200402902004029
0200302902003029020030290200302902003030020440090200000002000000020000000200000002000000020000000200000002000000020000000200000002000000020000000200000002000000020440090202702702027029020270290202702902027029020270300200402702004029020040290200402902004029020040300200000002000000020000000200000002000000020000000200000002000000020000000200302702004029020030280200402902004029
0200302902003029020030290200302902006028020020280200202802002028020020280200202802002028020020280200202802002028020020300200000002044009020000000200000002000000020000000202702702027029020270290202702902027029020270300200402702004029020040290200402902004029020040300200000002002027020020280200202802002028020020280200202802002028020020280200602702004029020030280200402902004029
0200302902003029020030290200302902003029020030290200302902003029020030290200302902003029020030290200302902003029020030300200000002000000020000000200000002000000020000000202702702027029020270290202702902027029020270300200402702004029020040290200402902004029020040300200000002004027020030280200302802003028020030280200302802003028020030280200302802004029020030280200402902004029
0200302902003029020030290200302902003029020030290200302902003029020030290200302902003029020030290200302902003029020030300200000002000000020000000200000002000000020000000202702702027029020270290202702902027029020270300200402702004029020040290200402902004029020040300200000002004027020030280200302802003028020030280200302802003028020030280200302802003028020030280200402902004029
0200302902003029020030290200302902003029020030290200302902003029020030290200302902003029020030290200302902003029020030300200000002000000020000000200000002000000020000000202702702027029020270290202702902027029020270300200402702004029020040290200402902004029020040300200000002004027020030280200302802003028020030280200302802003028020030280200302802003028020030280200302802004029
0200302902003029020030290200302902003029020030290200302902003029020030290200302902003029020030290200302902003029020030300200000002000000020000000200000002000000020000000202702702027029020270290202702902027029020270300200402702004029020040290200402902004029020040300200000002004027020030280200302802003028020030280200302802003028020030280200302802003028020030280200302802004029
0200302902003029020030290200302902003029020030290200302902003029020030290200302902003029020030290200302902003029020040300200000002044009020000000200000002000000020070190202702702027029020270290202702902027029020270300200402702004029020040290200402902004029020040300200000002004027020030280200302802003028020030280200302802003028020030280200302802003028020030280200302802004029
