47
40
090010070900100809001007090010060900100709001006090010070900100609001007090010060900100709001006090010070900100609001007090010060900100709001006090010070900100609001009020-10-1020-10-1020-10-1020-10-1020-10-1020-10-10900100509001006090010070900100809001007090010080900100709001008090010070900100809001007090010080900100709001008090010070900100609001007090010080900100709001008
090020070900200809002007090020060900200709002006090020070900200609002007090020060900200709002006090020070900200609002007090020060900200709002006090020070900200609002009020-10-1020-10-1020-10-1020-10-1020-10-1020-10-10900200509002006090020070900200809002007090020080900200709002008090020070900200809002007090020080900200709002008090020070900200609002007090020080900200709002008
090010070900100809001007090010060900300709003008090030070900300609003007090030060900300709003006090030070900300609003007090030060900300709003006090030070900300809003009020-10-1020-10-1020-10-1020-10-1020-10-1020-10-10900300509003006090030070900300609003007090030060900300709003006090030070900300609003007090030060900300709003006090030070900300609003007090010060900100709001008
090020070900200809002007090020080900400709004008090040070900400609004007090040060900400709004006090040070900400609004007090040060900400709004006090040070900400809004009020-10-1020-10-1020-10-1020-10-1020-10-1020-10-10900400509004006090040070900400609004007090040060900400709004006090040070900400609004007090040060900400709004006090040070900400609002007090020080900200709002008
0900100709001008090010070900300809003009020-10-1020-10-1020-10-1020-10-1020-10-1020-10-1020-10-1020-10-1020-10-1020-10-1020-10-1020-10-1020-10-1020-10-1020-10-1020-10-1020-10-1020-10-1020-10-1020-10-1020-10-1020-10-1020-10-1000-10-1000-10-1020-10-1020-10-1020-10-1020-10-1020-10-1020-10-1020-10-1020-10-1020-10-1020-10-1020-10-1020-10-1020-10-109003007090030080900100709001008
0900200709002008090020070900200809002009020-10-1020-10-1020-10-1020-10-1020-10-1020-10-1020-10-1020-10-1020-10-1020-10-1020-10-1020-10-1020-10-1020-10-1020-10-1020-10-1020-10-1020-10-1020-10-1020-10-1020-10-1020-10-1020-10-1020-10-1020-10-1020-10-1020-10-1020-10-1020-10-1020-10-1020-10-1020-10-1020-10-1020-10-1020-10-1020-10-1020-10-1020-10-109002005090020060900200709002008
0900100709001008090010070900100809001009020-10-1020-10-1020-10-1020-10-1020-10-1020-10-1020-10-1020-10-1020-10-1020-10-1020-10-1020-10-1020-10-1020-10-1020-10-1020-10-1020-10-1020-10-1020-10-1020-10-1020-10-1020-10-1020-10-1020-10-1020-10-1020-10-1020-10-1020-10-1020-10-1020-10-1020-10-1020-10-1020-10-1020-10-1020-10-1020-10-1020-10-1020-10-109001005090010060900100709001008
0900200709002008090020070900200809002009020-10-1020-10-1020-10-1020-10-1020-10-1020-10-1020-10-1020-10-1020-10-1020-10-1020-10-1020-10-1020-10-1020-10-1020-10-1020-10-1020-10-1020-10-1020-10-1020-10-1020-10-1020-10-1020-10-1020-10-1020-10-1020-10-1020-10-1020-10-1020-10-1020-10-1020-10-1020-10-1020-10-1020-10-1020-10-1020-10-1020-10-1020-10-109002005090020060900200709002008
0900100709001008090010070900100809001009020-10-1020-10-1020-10-1020-10-1020-10-1020-10-1020-10-1020-10-1020-10-1020-10-1020-10-1020-10-1020-10-1020-10-1020-10-1020-10-1020-10-1020-10-1020-10-1020-10-1020-10-1020-10-1020-10-1020-10-1020-10-1020-10-1020-10-1020-10-1020-10-1020-10-1020-10-1020-10-1020-10-1020-10-1020-10-1020-10-1020-10-1020-10-109001005090010060900100709001008
0900200709002008090020070900200809002009020-10-1020-10-1020-10-1020-10-1020-10-1020-10-1020-10-1020-10-1020-10-1020-10-1020-10-1020-10-1020-10-1020-10-1020-10-1020-10-1020-10-1020-10-1020-10-1020-10-1020-10-1020-10-1020-10-1020-10-1020-10-1020-10-1020-10-1020-10-1020-10-1020-10-1020-10-1020-10-1020-10-1020-10-1020-10-1020-10-1020-10-1020-10-109002005090020060900200709002008
0900100709001008090010070900100809001009020-10-1020-10-1020-10-1020-10-1020-10-1020-10-1020-10-1020-10-1020-10-1020-10-1020-10-1020-10-1020-10-1020-10-1020-10-1020-10-1020-10-10001802800018029020-10-1020-10-1020-10-1020-10-1020-10-1020-10-1020-10-1020-10-1020-10-1020-10-1020-10-1020-10-1020-10-1020-10-1020-10-1020-10-1020-10-1020-10-1020-10-109001005090010060900100709001008
0900200709002008090020070900200809002009020-10-1020-10-1020-10-1020-10-1020-10-1020-10-1020-10-1020-10-1020-10-1020-10-1020-10-1020-10-1020-10-1020-10-1020-10-1020-10-1020-10-100019028000190290001903000019031020-10-1020-10-1020-10-1020-10-1020-10-1020-10-10005605800056059000560600005606100056062020-10-1020-10-1020-10-1020-10-1020-10-1020-10-109002005090020060900200709002008
0900100709001008090010070900100809001009020-10-1020-10-1020-10-1020-10-10900000509000006090000070900000809000009020-10-1020-10-1020-10-1020-10-1020-10-1020-10-1020-10-1020-10-100020028000200290002003000020031020-10-1020-10-1020-10-1020-10-1020-10-1020-10-10005705800057059000570600005706100057062020-10-1020-10-1020-10-1020-10-1020-10-1020-10-109001005090010060900100709001008
0900200709002008090020070900200809002009020-10-1020-10-1020-10-1020-10-10900100509001006090010070900100809001009020-10-1020-10-1020-10-1020-10-1020-10-1020-10-1020-10-1020-10-100021028000210290002103000021031020-10-1020-10-1020-10-1020-10-1020-10-1020-10-10005805800058059000580600005806100058062020-10-1020-10-1020-10-1020-10-1020-10-1020-10-109002005090020060900200709002008
0900100709001008090010070900100809001009020-10-1020-10-1020-10-1020-10-10900200509002006090020070900200809002009020-10-1020-10-1020-10-1020-10-1020-10-1020-10-1020-10-1020-10-100022028000220290002203000022031020-10-1020-10-1020-10-1020-10-1020-10-1020-10-10005905800059059000590600005906100059062020-10-1020-10-1020-10-1020-10-1020-10-1020-10-109001005090010060900100709001008
0900200709002008090020070900200809002009020-10-1020-10-1020-10-1020-10-10900100509001006090010070900100809001009020-10-1020-10-1020-10-1020-10-1020-10-1020-10-1020-10-1020-10-1020-10-1020-10-1020-10-1020-10-1020-10-1020-10-1020-10-1020-10-1020-10-1020-10-10006005800060061000600610006006100060062020-10-1020-10-1020-10-1020-10-1020-10-1020-10-109002005090020060900200709002008
0900100709001008090010070900100809001009020-10-1020-10-109000005090000060900200509002006090020070900200809002009020-10-1020-10-1020-10-1020-10-1020-10-1020-10-1020-10-1020-10-1020-10-1020-10-1020-10-1020-10-1020-10-1020-10-1020-10-1020-10-1020-10-1020-10-1020-10-1020-10-1020-10-1020-10-1020-10-1020-10-1020-10-1020-10-1020-10-1020-10-1020-10-109001005090010060900100709001008
0900200709002008090020070900200809002009020-10-1020-10-109001005090010060900100709001006090010070900100809001009020-10-1020-10-1020-10-1020-10-1020-10-1020-10-1020-10-1020-10-1020-10-1020-10-1020-10-1020-10-1020-10-1020-10-1020-10-1020-10-1020-10-1020-10-1020-10-1020-10-1020-10-1020-10-1020-10-1020-10-1020-10-1020-10-1020-10-1020-10-1020-10-109002005090020060900200709002008
0900100709001008090010070900100809001009020-10-1020-10-109002005090020060900200709002006090020070900200809002009020-10-1020-10-1020-10-102006007020060070200600702006007020-10-1020-10-1020-10-1020-10-1020-10-1020-10-1020-10-1020-10-1020-10-1020-10-1020-10-1020-10-1020-10-1020-10-1020-10-1020-10-1020-10-1020-10-1020-10-1020-10-1020-10-1020-10-109001005090010060900100709001008
0900200709002008090020070900200809002009020-10-1020-10-109003005090030060900300709003006090030070900300809003009020-10-1020-10-1020-10-102007007020070070200700702007007020-10-1020-10-1020-10-1020-10-1020-10-1020-10-1020-10-1020-10-1020-10-1020-10-1020-10-1020-10-1020-10-1020-10-1020-10-1020-10-1020-10-1020-10-1020-10-1020-10-1020-10-1020-10-109002005090020060900200709002008
0900100709001006090010070900100809001009020-10-1020-10-109004005090040060900400709004006090040070900400809004009020-10-1020-10-1020-10-102007007020070070200700702007007020-10-1020-10-1020-10-1000150150001501600015017020-10-1020-10-1020-10-1020-10-1020-10-1020-10-1000150150001501600015017020-10-1020-10-1020-10-1020-10-1020-10-1020-10-1020-10-109001005090010060900100709001008
0900200709002006090020070900200809002009020-10-1020-10-1020-10-1020-10-1020-10-1020-10-1020-10-1020-10-1020-10-1020-10-1020-10-1020-10-102007007020070070200700702007007020-10-1020-10-10001601400016015000160160001601700016018020-10-1020-10-1020-10-1020-10-10001601400016015000160160001601700016018020-10-1020-10-1020-10-1020-10-1020-10-1020-10-109002005090020060900200709002008
0900100709001006090010070900100809001009020-10-1020-10-1020-10-10900000509000006090000070900000809000009020-10-1020-10-1020-10-1020-10-102007007020070070200700702007007020-10-100017013000170140001701500017016000170170001701800017019020-10-1020-10-100017013000170140001701500017016000170170001701800017019020-10-1020-10-1020-10-1020-10-1020-10-109001005090010060900100709001008
0900200709002006090020070900200809002009020-10-1020-10-1020-10-10900100509001006090010070900100809001009020-10-1020-10-1020-10-1020-10-1020-10-1020-10-1020-10-1020-10-1020-10-100018013000180140001801500018016000180170001801800018019020-10-1020-10-100018013000180140001801500018016000180170001801800018019020-10-1020-10-1020-10-1020-10-1020-10-109002005090020060900200709002008
0900100709001006090010070900100809001009020-10-1020-10-1020-10-10900200509002006090020070900200809002009020-10-1020-10-1020-10-1020-10-1020-10-1020-10-1020-10-1020-10-1020-10-1000190130001901400019015020-10-1000190170001901800019019020-10-1020-10-1000190130001901400019015020-10-1000190170001901800019019020-10-1020-10-1020-10-1020-10-1020-10-109001005090010060900100709001008
0900200709002006090020070900200809002009020-10-1020-10-1020-10-10900100509001006090010070900100809001009020-10-1020-10-1020-10-1020-10-1020-10-1020-10-1020-10-1020-10-1020-10-10002001300020014020-10-1020-10-1020-10-10002001800020019020-10-1020-10-100020013020-10-1020-10-1020-10-1020-10-10002001800020019090000050900000609000009020-10-1020-10-109002005090020060900200709002008
0900100709001006090010070900100809001009020-10-1020-10-1020-10-10900200509002006090020070900200809002009020-10-1020-10-1020-10-1020-10-1020-10-1020-10-1020-10-1020-10-1020-10-1020-10-1020-10-1020-10-1020-10-1020-10-1020-10-1020-10-1020-10-1020-10-1020-10-1020-10-1020-10-1020-10-1020-10-1020-10-1020-10-1090010050900100609001009020-10-1020-10-109001005090010060900100709001008
0900200709002006090020070900200809002009020-10-1020-10-1020-10-10900100509001006090010070900100809001009020-10-1020-10-1020-10-1020-10-1020-10-1020-10-1020-10-1020-10-1020-10-1020-10-1020-10-1020-10-1020-10-1020-10-1020-10-1020-10-1020-10-1020-10-1020-10-1020-10-1020-10-1020-10-1020-10-1020-10-1020-10-1090020050900200609002009020-10-1020-10-109002005090020060900200709002008
0900100709001006090010070900100809001009020-10-1020-10-1020-10-10900200509002006090020070900200809002009020-10-1020-10-1020-10-1020-10-1020-10-1020-10-1020-10-1020-10-1020-10-1020-10-1020-10-1020-10-1020-10-1020-10-1020-10-1020-10-1020-10-1020-10-1020-10-1020-10-1020-10-1020-10-1020-10-1020-10-1020-10-1090010050900100609001009020-10-1020-10-109001005090010060900100709001008
0900200709002006090020070900200809002009020-10-1020-10-1020-10-10900300509003006090030070900300809003009020-10-1020-10-1020-10-1020-10-1020-10-1020-10-1020-10-1020-10-1020-10-1020-10-1020-10-1020-10-1020-10-1020-10-1020-10-109000005090000060900000709000006090000070900000609000007090000060900000709000006090020050900200609002009020-10-1020-10-109002005090020060900200709002008
0900100709001006090010070900100809001009000-10-1020-10-1020-10-10900400509004006090040070900400809004009020-10-1020-10-1020-10-1020-10-1020-10-1020-10-1020-10-1020-10-1020-10-1020-10-1020-10-1020-10-1020-10-1020-10-1020-10-109001005090010060900100709001006090010070900300609003007090030060900300709003006090030070900300809003009020-10-1020-10-109001005090010060900100709001008
0900200709002006090020070900200809002009000-10-1020-10-1020-10-1020-10-1020-10-1020-10-1020-10-1020-10-1020-10-1020-10-1020-10-1020-10-1020-10-1020-10-1020-10-1020-10-1020-10-1020-10-1020-10-1020-10-1020-10-1020-10-1020-10-109002005090020060900200709002006090020070900400609004007090040060900400709004006090040070900400809004009020-10-1020-10-109002005090020060900200709002008
0900100709001006090010070900100809001009020-10-1020-10-1020-10-1020-10-1020-10-1020-10-1020-10-1020-10-1020-10-1020-10-1020-10-1020-10-1020-10-1020-10-1020-10-1020-10-1020-10-1020-10-1020-10-1020-10-1020-10-1020-10-1020-10-10900100509001006090010070900100809001009020-10-1000-10-1000-10-1000-10-1020-10-1020-10-1020-10-1020-10-1020-10-1020-10-109001005090010060900100709001008
090020070900200609002007090020080900000709000008090000070900000609000007090000060900000709000006090000070900000809000009020-10-1020-10-1020-10-1020-10-1020-10-1020-10-1020-10-1020-10-1020-10-1020-10-1020-10-1020-10-1020-10-10900200509002006090020070900200809002009020-10-1020-10-1020-10-1020-10-1020-10-1020-10-1020-10-1020-10-1020-10-1020-10-109002005090020060900200709002008
090010070900100609001007090010060900100709001008090010070900100609001007090010060900100709001006090010070900100809001009020-10-1020-10-1020-10-1020-10-1020-10-1020-10-1020-10-1020-10-1020-10-1020-10-1020-10-1020-10-1020-10-10900100509001006090010070900100809001009020-10-1020-10-1020-10-1020-10-1020-10-1020-10-1020-10-1020-10-1020-10-1020-10-109001005090010060900100709001008
090020070900200609002007090020060900200709002006090020070900200609002007090020060900200709002006090020070900200809002009020-10-1020-10-1020-10-1020-10-1020-10-1020-10-1020-10-1020-10-1020-10-1020-10-1020-10-1020-10-1020-10-10900200509002006090020070900200809002009020-10-1020-10-1090000050900000609000007090000080900000709000008090000070900000809002005090020060900200709002008
090010070900100609001007090010060900100709001006090010070900100609001007090010060900100709001006090010070900100809001009020-10-1020-10-1020-10-1020-10-1020-10-1020-10-1020-10-1020-10-1020-10-1020-10-1020-10-1020-10-1020-10-10900100509001006090010070900100809001009020-10-1020-10-1090010050900100609001007090010080900100709001008090010070900100809001007090010060900100709001008
090020070900200609002007090020060900200709002006090020070900200609002007090020060900200709002006090020070900200809002009020-10-1020-10-1020-10-1020-10-1020-10-1020-10-1020-10-1020-10-1020-10-1020-10-1020-10-1020-10-1020-10-10900200509002006090020070900200809002009020-10-1020-10-1090020050900200609002007090020060900200709002006090020070900200609002007090020060900200709002008
090010070900100809001007090010080900100709001008090010070900100809001007090010080900100709001008090010070900100809001009020-10-1020-10-1020-10-1020-10-1020-10-1020-10-1020-10-1020-10-1020-10-1020-10-1020-10-1020-10-1020-10-10900100509001006090010070900100809001009020-10-1020-10-1090010050900100609001007090010060900100709001006090010070900100609001007090010060900100709001008
090020070900200809002007090020080900200709002008090020070900200809002007090020080900200709002008090020070900200809002009020-10-1020-10-1020-10-1020-10-1020-10-1020-10-1020-10-1020-10-1020-10-1020-10-1020-10-1020-10-1020-10-10900200509002006090020070900200809002009020-10-1020-10-1090020050900200609002007090020060900200709002006090020070900200609002007090020060900200709002008
