47
40
00000000000000000000000000001111111111111111111
01100111111111111110000000001111111111111111111
01100111111111111110000000000000000000000000000
01111111111111111111100000011111111111111111111
01111111111111111111100000011111111111111111111
01111000000000000000000000000000000000000000111
01111000000000000000000000000000000000000000111
01111000000000000000000000000000000000000000111
01111000000000000000000000000000000000000000111
01111000000000000000000000000000000000000000111
01111000000000000000000000000000000000000000111
01111000000000000000000000000000000000000000111
01111000000000000000000000000000000000000000111
01111000000000000000000000000000000000000000111
01111000011111000000001111000000111110000000111
01111000011111000000001011000000111110000000111
01111000001111000000000000000000110110000000111
01111000001111000000000000000000000000000000111
01111001111111000000000000000000000000000000000
01111001111111000000000000000000000000000000000
01111001111111000111100000000000000000000000111
01111001111111000111100000000000000000000000111
01111000000000000111100000000000000000000000111
01111000000000000111100011100000011100000000111
01111000111110000000000111110000111110000000111
01111000111110000000000111110000111110000000111
01111000111110000000001101110000101110000000111
01111000111110000000000000000000000000011000111
01111000111110000000000000000000000000011000111
01111000111110000000000000000000000000011000111
01111000111110000000000000000001100000011000111
01111000111110000000000000000111111111111000111
01111000000000000000000000000111111111111000111
01100000000000000000000000000110000000000000111
01100000000000000000000000000110000000000000111
01111111111110000000000000000110000000000001111
01111111111110000000000000000110000011111111111
01111111111110000000000000000110000011111111111
01111111111110000000000000000110000011111111111
01111111111111000000000000000110010011111111111
