40
40
000-10-1000-10-1000-10-1000-10-1000-10-1000-10-1000-10-1000-10-1020-10-1020-10-1020-10-1020-10-1020-10-10703901907039020020-10-1020-10-1020-10-1020-10-103001004020-10-1020-10-1020-10-1020-10-1020-10-10300100207014013020-10-1020-10-1020-10-107042022020-10-1020-10-1020-10-1020-10-1020-10-10704201907042020020-10-1020-10-1
000-10-107042022000-10-1000-10-1000-10-1000-10-1000-10-1000-10-1020-10-107042022020-10-1020-10-1020-10-10704001907040020020-10-1020-10-1020-10-1020-10-103001004020-10-1020-10-1020-10-1020-10-1020-10-10300100207015013020-10-1020-10-1020-10-1020-10-1020-10-1020-10-10704101907041020020-10-10704301907043020020-10-1020-10-1
000-10-1000-10-1000-10-10703901907039020000-10-1000-10-1000-10-1020-10-1020-10-1020-10-1020-10-1020-10-1020-10-1020-10-1020-10-107042022020-10-1020-10-103001004020-10-1020-10-1020-10-1020-10-1020-10-10300100207014013020-10-10704201907042020020-10-1020-10-1020-10-1020-10-1020-10-1020-10-1020-10-1020-10-1020-10-107042024
000-10-1000-10-1000-10-10704001907040020020-10-1000-10-1000-10-1020-10-1020-10-1020-10-1020-10-1020-10-1020-10-10704102107041022020-10-1020-10-1020-10-103001004020-10-1020-10-1020-10-1020-10-1020-10-10300100207015013020-10-107043019070430200704102107041022020-10-107042022020-10-1020-10-1020-10-1020-10-1020-10-1020-10-1
000-10-1000-10-1000-10-1000-10-1000-10-107042024000-10-1020-10-1000-10-1020-10-1020-10-1020-10-1020-10-1020-10-1020-10-1020-10-1020-10-1020-10-1020-10-103001004020-10-1020-10-1020-10-1020-10-1020-10-10300100207014013020-10-1020-10-1020-10-1020-10-1020-10-1020-10-1020-10-1020-10-1020-10-1020-10-107042024020-10-1020-10-1
000-10-1000-10-1000-10-1020-10-1000-10-1020-10-1020-10-1000-10-1020-10-1020-10-1020-10-1020-10-1020-10-1020-10-1020-10-1020-10-1020-10-1020-10-1020-10-103001004020-10-1020-10-1020-10-1020-10-1020-10-10300100207015011070130120701301107013012070130110701301207013011070130120701301107013012020-10-1070130120701301107013012
07042024000-10-1000-10-1000-10-1020-10-1000-10-1000-10-103000002030000030300000303000003030000030300000303000003030000030300000303000003030000030300000303002004020-10-1020-10-1020-10-1020-10-1020-10-1030020020300200303002003030020030300200007035019070350200300000003000003030000030300000303000003030000030300000303000001
000-10-1000-10-1000-10-1000-10-10704102107041022020-10-103001002020-10-1020-10-1020-10-1020-10-1020-10-1020-10-1020-10-1020-10-1020-10-1020-10-1020-10-1020-10-1020-10-1020-10-1020-10-1020-10-1020-10-1020-10-1020-10-1020-10-1020-10-1020-10-10703601907036020020-10-1020-10-1020-10-1020-10-1020-10-1020-10-1020-10-102029001
000-10-1000-10-1000-10-1000-10-1000-10-1000-10-1020-10-103001002020-10-1020-10-1020-10-1020-10-1020-10-1020-10-1020-10-1020-10-1020-10-1020-10-1020-10-1020-10-1020-10-1020-10-1020-10-1020-10-1020-10-1020-10-1020-10-1020-10-1020-10-1020-10-1020-10-1020-10-1020-10-1020-10-1020-10-1020-10-1020-10-1070-10-102029001070-10-1
000-10-1000-10-1000-10-1000-10-1000-10-1000-10-1000-10-103001002020-10-1020-10-1020-10-1020-10-1020-10-1020-10-1020-10-1020-10-1020-10-1020-10-1020-10-1020-10-1020-10-1020-10-1020-10-1020-10-1020-10-1020-10-1020-10-1020-10-1020-10-1020-10-1020-10-1020-10-1020-10-1020-10-1020-10-1020-10-1020-10-1070-10-1070-10-102029003
000-10-10703902107039022000-10-107042022020-10-1020-10-103001002020-10-1020-10-1020-10-1020-10-1020-10-1020-10-1020-10-1020-10-1020-10-1020-10-1020-10-1020-10-1020-10-1020-10-1020-10-1020-10-1020-10-1020-10-1020-10-1020-10-1020-10-1020-10-1020-10-1020-10-1020-10-1020-10-1020-10-1020-10-1020-10-1070350190703502007035019
000-10-10704002107040022000-10-1000-10-1000-10-1020-10-103001002020-10-1020-10-1020-10-1020-10-1020-10-1020-10-1020-10-1020-10-1020-10-1020-10-1020-10-1020-10-1020-10-1020-10-1020-10-1020-10-1020-10-1020-10-1020-10-1020-10-1020-10-1020-10-1020-10-1020-10-1020-10-1020-10-1020-10-1020-10-1020-10-1070360190703602007036019
000-10-1000-10-1000-10-1000-10-1000-10-1000-10-1020-10-103001002020-10-1020-10-1020-10-1020-10-1020-10-1020-10-1020-10-1020-10-1020-10-1020-10-1020-10-1020-10-1020-10-1020-10-1020-10-1020-10-1020-10-1020-10-1020-10-1020-10-1020-10-1020-10-1020-10-1020-10-1020-10-1020-10-1020-10-1020-10-1020-10-1070350190703502007035019
000-10-1000-10-1000-10-1000-10-1000-10-1020-10-1020-10-103001002020-10-1020-10-1040650470406504804065049040650500003903400039035000390360003903700039038020-10-1020-10-1020-10-1020-10-1020-10-1020-10-1020-10-1020-10-1020-10-1020-10-1020-10-1020-10-1020-10-1020-10-1020-10-1020-10-1020-10-1020-10-1070360190703602007036019
000-10-10704201907042020000-10-1000-10-1020-10-1020-10-103001002020-10-1020-10-104066047020-10-104066049040660500004003400040035020-10-10004003700040038020-10-1020-10-1020-10-1020-10-1020-10-1020-10-1020-10-1020-10-1020-10-104047065040470660404706704047068040470690404707004047071020-10-1020-10-1070350190703502007035019
000-10-10704301907043020000-10-1000-10-1000-10-1020-10-103001002020-10-1020-10-1020-10-1020-10-1020-10-1020-10-1020-10-100041035020-10-100041037020-10-1020-10-1020-10-1020-10-1020-10-1020-10-1020-10-1020-10-1020-10-1020-10-104048065040480660404806704048068040480690404807004048071020-10-1020-10-1070360190703602007036019
000-10-1000-10-1000-10-1000-10-1020-10-1020-10-1020-10-103001002020-10-1020-10-1020-10-1020-10-1020-10-1020-10-1020-10-1020-10-1020-10-1020-10-1020-10-1020-10-1020-10-1020-10-1020-10-1020-10-1020-10-1020-10-1020-10-1020-10-1020-10-1020-10-104049067020-10-104049069020-10-1020-10-1020-10-1020-10-1070350190703502007035019
000-10-1000-10-1000-10-1000-10-1000-10-1020-10-1000-10-103001002020-10-1020-10-1020-10-1020-10-1020-10-1020-10-1020-10-1020-10-1020-10-1020-10-1020-10-1020-10-1020-10-1020-10-1020-10-1020-10-1020-10-1020-10-1020-10-1020-10-1020-10-1020-10-1020-10-1020-10-1020-10-1020-10-1020-10-1020-10-1020-10-1070360190703602007036019
0300000303000003030000030300000303000003030000030300000303002004020-10-1020-10-1020-10-1020-10-1020-10-1020-10-1020-10-1020-10-1020-10-1020-10-1020-10-1020-10-1020-10-1020-10-1020-10-1020-10-1020-10-1020-10-1020-10-1020-10-1020-10-1020-10-1020-10-1020-10-1020-10-1020-10-1020-10-1020-10-1020-10-1070350190703502007035019
000-10-1000-10-1000-10-1020-10-1000-10-1000-10-1020-10-1020-10-1020-10-1020-10-1020-10-1020-10-1020-10-1020-10-1020-10-1020-10-1020-10-1020-10-1020-10-1020-10-1020-10-1020-10-1020-10-1020-10-1020-10-1020-10-1020-10-1020-10-1020-10-1020-10-1020-10-1020-10-1020-10-1020-10-1020-10-1020-10-1020-10-1070360190703602007036019
000-10-1000-10-1000-10-1000-10-1000-10-1020-10-1020-10-1020-10-1020-10-1020-10-1020-10-1020-10-1020-10-1020-10-1020-10-1020-10-1020-10-1020-10-1020-10-1020-10-1020-10-1020-10-1020-10-1020-10-1020-10-1020-10-1020-10-1020-10-1020-10-1020-10-1020-10-1020-10-1020-10-1020-10-1020-10-1020-10-1020-10-1020-10-1020-10-1020-10-1
020-10-1020-10-1000-10-1000-10-1000-10-1020-10-1020-10-1020-10-1020-10-1020-10-1020-10-1020-10-1020-10-1020-10-1020-10-100007008020-10-1020-10-100007011020-10-1020-10-1000040590000406000004061000040620000406300004064000040650000406600004067000040680000406900004070000040710000407200004073020-10-1020-10-1020-10-1020-10-1
000-10-1000-10-1000-10-1020-10-1020-10-1020-10-1020-10-1020-10-1020-10-1020-10-1020-10-1020-10-1020-10-1020-10-1020-10-100008008000080090000801000008011020-10-1020-10-1000050590000506000005061000050620000506300005064000050650000506600005067000050680000506900005070000050710000507200005073020-10-1020-10-1020-10-1020-10-1
020-10-1020-10-1000-10-1020-10-1020-10-1020-10-1020-10-1020-10-1020-10-1020-10-1020-10-1020-10-1020-10-1020-10-1020-10-100009008020-10-10000901000009011020-10-1020-10-1000060590000606000006061000060620000606300006064000060650000606600006067000060680000606900006070000060710000607200006073020-10-1020-10-1020-10-1020-10-1
020-10-1020-10-1020-10-1020-10-1020-10-1020-10-1020-10-1020-10-1020-10-1020-10-1020-10-1020-10-1020-10-1020-10-1020-10-1020-10-1020-10-1020-10-1020-10-1020-10-1020-10-1000070590000706000007061000070620000706300007064000070650000706600007067000070680000706900007070000070710000707200007073020-10-1020-10-1020-10-1020-10-1
020-10-1020-10-1020-10-1020-10-1020-10-1020-10-1020-10-1020-10-1020-10-1020-10-1020-10-1020-10-1020-10-1020-10-1020-10-1020-10-1020-10-1020-10-1020-10-1020-10-1020-10-1000080590000806000008061000080620000806300008064000080650000806600008067000080680000806900008070000080710000807200008073020-10-1020-10-1020-10-102028003
02025005020250060202500502025006020250050202500602025005020250060202500502025006020-10-1020-10-1020-10-1020-10-1020-10-1020-10-1020-10-1020-10-1020-10-1020-10-1020-10-1000090590000906000009061000090620000906300009064000090650000906600009067000090680000906900009070000090710000907200009073020-10-1020-10-10703102407031025
02026005020260060202600502026006020260050202600602026005020260060202600502026006020-10-1070-10-1020-10-1020-10-1020-10-1020-10-1020-10-1020-10-1020-10-1020-10-1020-10-1000100590001006000010061000100620001006300010064000100650001006600010067000100680001006900010070000100710001007200010073020-10-1020-10-10703202407032025
0201900102019002020-10-1020-10-1020-10-1020-10-1020-10-1020-10-1020-10-1020-10-1020-10-1020-10-1020-10-1020-10-1020-10-1020-10-1020-10-1020-10-1020-10-1020-10-1020-10-1000130590001306000013061000130620001306300013064000130650001306600013067000130680001306900013070000130710001307200013073020-10-1020-10-1020-10-102028003
0202000102020002020-10-10703102007031021020-10-1020-10-1020-10-1020-10-1020-10-1020-10-1020-10-1020-10-1020-10-1020-10-1020-10-1020-10-1020-10-1020-10-1020-10-1020-10-1000140590001406000014061000140620001406300014064020-10-1020-10-1020-10-1000140680001406900014070000140710001407200014073020-10-1020-10-10701902407019025
0201900102019002020-10-10703202007032021020-10-1020-10-1020-10-102008007020-10-1020-10-1020-10-1020-10-1020-10-1020-10-1020-10-1020-10-1020-10-1020-10-1020-10-1020-10-1000150590001506000015061000150620001506300015064020-10-1020-10-1020-10-1000150680001506900015070000150710001507200015073020-10-1020-10-10702002407020025
0202000102020002020-10-1020-10-1020-10-1020-10-1020-10-1020-10-102008007020-10-1020-10-1020-10-1020-10-1020-10-1020-10-1020-10-1020-10-1020-10-1020-10-1020-10-1020-10-1020-10-1020-10-1020-10-1020-10-1020-10-1020-10-1020-10-1020-10-1020-10-1020-10-1020-10-1020-10-1020-10-1020-10-1020-10-1020-10-1020-10-10202800102028000
070370230703702407037023070370240703702307037024070370230703702402008007020-10-1020-10-1020-10-1020-10-1020-10-1020-10-1020-10-102008007020-10-1020-10-1020-10-1020-10-1020-10-1020-10-1020-10-1020-10-1020-10-1020-10-1020-10-1020-10-1020-10-1020-10-1020-10-1020-10-1020-10-1020-10-1020-10-1020-10-1020-10-10202800002028001
070380230703802407038023070380240703802307038024070380230703802402008007020-10-1020-10-1020-10-1020-10-1020-10-1020-10-1020-10-102008007020-10-1020-10-1020-10-1020-10-1020-10-1020-10-1020-10-1020-10-1020-10-1020-10-1020-10-1020-10-1020-10-1020-10-1020-10-1020-10-1020-10-1020-10-10202500102025002020-10-1020-10-102028001
070370230703702407037023070370240703702307037024070370230703702402008007020-10-1020-10-1020-10-1020-10-1020-10-1020-10-1020-10-102008007020-10-1020-10-1020-10-1020-10-1020-10-1020-10-1020-10-1020-10-1020-10-1020-10-1020-10-1020-10-1020-10-1020-10-1020-10-1020-10-1020-10-1020-10-10202600102026002020260010202600202026001
070380230703802407038023070380240703802307038024070380230703802402008007020-10-1020-10-1020-10-1020-10-1020-10-1020-10-1020-10-102008007020-10-1020-10-1020-10-1020-10-1020-10-1020-10-1020-10-1020-10-1020-10-1020-10-1020-10-1020-10-1020-10-1020-10-1020-10-1020-10-1020-10-1020-10-10202600102026002020260010202600202026001
070370230703702407037023070370240703702307037024070370230703702402008007020-10-1020-10-1020-10-1020-10-1020-10-1020-10-1020-10-102008007020-10-1020-10-1020-10-1020-10-1020-10-1020-10-1020-10-1020-10-1020-10-1020-10-1020-10-1020-10-1020-10-1020-10-1020-10-1020-10-1020-10-1020-10-10202600102026002020260010202600202026001
070380230703802407038023070380240703802307038024070380230703802402008007020-10-1020-10-1020-10-1020-10-1020-10-1020-10-1020-10-102008007020-10-1020-10-1020-10-1020-10-1020-10-1020-10-1020-10-1020-10-1020-10-1020-10-1020-10-1020-10-1020-10-1020-10-1020-10-1020-10-1020-10-1020-10-10202600102026002020260010202600202026001
070370230703702407037023070370240703702307037024070370230703702402008007020-10-1020-10-1020-10-1020-10-1020-10-1020-10-1020-10-102008007020-10-1020-10-1020-10-1020-10-1020-10-1020-10-1020-10-1020-10-1020-10-1020-10-1020-10-1020-10-1020-10-1020-10-1020-10-1020-10-1020-10-1020-10-10202600102026002020260010202600202026001
070380230703802407038023070380240703802307038024070380230703802402008007020-10-1020-10-1020-10-1020-10-1020-10-1020-10-1020-10-102008007020-10-1020-10-1020-10-1020-10-1020-10-1020-10-1020-10-1020-10-1020-10-1020-10-1020-10-1020-10-1020-10-1020-10-1020-10-1020-10-1020-10-1020-10-10202600102026002020260010202600202026001
