40
40
02031010020310100203101002031010020310100203101002031010020310100203101002031010020310100203101002031010020310100203101002031010020310100203101002031010030010040704201007041015070410140704101407041013070140150203101002031010020310100203101002031010020310100203101002031010020310100203101002031010020310100203101002031010
02031010020310100203101002031010020310100203101002031010020310100203101002031010020310100203101002031010020310100203101002031010020310100203101002031010030010040704101007041014070410140704101407042013070140150203101002031010020310100203101002031010020310100203101002031010020310100203101002031010020310100203101002031010
02031010020310100203101002031010020310100203101002031010020310100203101002031010020310100203101002031010020310100203101002031010020310100203101002031010030010040704201007041015070410140704101507041013070140150203101002031010020310100203101002031010020310100203101002031010020310100203101002031010020310100203101002031010
02031010020310100203101002031010020310100203101002031010020310100203101002031010020310100203101002031010020310100203101002031010020310100203101002031010030010040704101007041014070410140704101407042013070130150203101002031010020310100203101002031010020310100203101002031010020310100203101002031010020310100203101002031010
02031010020310100203101002031010020310100203101002031010020310100203101002031010020310100203101002031010020310100203101002031010020310100203101002031010030010040704201007041014070410150704101407041013070140150203101002031010020310100203101002031010020310100203101002031010020310100203101002031010020310100203101002031010
02031010020310100203101002031010020310100203101002031010020310100203101002031010020310100203101002031010020310100203101002031010020310100203101002031010030010040704101007041014070410140704101407042013070140150203101002031010020310100203101002031010020310100203101002031010020310100203101002031010020310100203101002031010
02031010020310100203101002031010020310100203101002031010020310100300000303000003030000030300000303000003030000030300000303000003030000030300000303000003030020040704201007040014070400140704001407041013070160140701601507014015070140150701601507014014070140140701401407016014070140150701401507016015070140150701401507014015
02031010020310100203101002031010020310100203101002031010020310100701301507014014070130150701601507014014070160140701501507015015070150140701601407015015070130150704101007040014070410150704001407041013070140140701601507014014070140140701401407014014070140140701301507014014070140140701301507014014070160150701401407016015
02031010020310100203101002031010020310100203101002031010020310100701501507013015070150140701501507016014070150150701501407013015070150150701301507016015070160140704201007040014070400140704001407041013070130150701401507013015070130150701301507013015070140150701401507013015070130150701501407013015070140150701301507013015
02031010020310100203101002031010020310100203101002031010020310100701301507040010070400120704001207040012070400120704001107040011070400110704001107040011070400120704201207040014070400140704001407042011070400110704001107040011070400120704001207040012070400120704001207040012070400120704001107040013070420140704201407042014
02031010020310100203101002031010020310100203101002031010020310100701501507041010070400150704001507040015070400150704001507040015070400150704001507040015070400150704001407040014070410150704001407040014070400140704001407041015070410150704101507041015070410150704101507041015070410150704101507041013070420140704201407042014
02031010020310100203101002031010020310100203101002031010020310100701301507041010070400150704001507040015070400150704001507040015070400150704001507040015070400150704001507041015070410150704001507041015070410150704001507041015070410150704101507041015070410150704101507041015070410150704101507042013070420140704201407042014
02031010020310100203101002031010020310100203101002031010020310100701401407041010070400150704001507040015070400150704001507040015070400150704001500061062070400150704101507041015070410150704101507041015070410150704101507041015070410150704101507041015070410150704101507041015070410150704101507042013070420140704201407042014
02031010020310100203101002031010020310100203101002031010020310100701301507041010070400150704001507040015070400150704001507040015070400150704001507040015070400150704101507041015070410150704101507041015070410150704101507041015070410150704101507041015070410150704101507041015070410150704101507042013070420140704201407042014
02031010020310100203101002031010020310100203101002031010020310100701301507042010070400150704001507040015070400150704001507040015070400150704001507040015070400150704101507041015070410150704101507041015070410150704101507041014070410150404706607041015040470680704101507041015070410150704101507042013070420140704201407042014
02031010020310100203101002031010020310100203101002031010020310100701501407041010070400150704101507040015070400150704001507040015070400150704001507040015070410150704101507041015070410150704101507041015070410140704101407041014070410150704101507041015070410150704101507041015070410150704101507042013070420140704201407042014
02031010020310100203101002031010020310100203101002031010020310100701301507041010070400150704001507041015070400150704101407041015070400150704001507041014070410140704101507041015070410150704101507041015070410150704101407041014070410150704101507041015070410150704101407041015070410140704101407042013070420140704201407042014
02031010020310100203101002031010020310100203101002031010020310100701501507041010070410140704101407041014070410140704101507041014070410140704101507041014070410140704101407040014070400140704001407040014070400140704001407040014070400140704001407040014070400140704001407040014070400140704001407042013070420140704201407042014
07042014070430150704201407042014070420140704301507042014070150140701401507041010070410140704101407041015070410150704101507041014070410150704101407041014070410150704101407040014070400140704001407040014070400140704001407040014070400140704001407040014070400140704001407040014070400140704001407042013070420140704201407042014
07040012070400110704001207040012070400120704001107040012070400120704001107042012070410150704101507041014070410140704101407041015070410140704101407041014070410140704101507040014070400140704001407040014070400140704001407040014070400140704001407040014070400140704001407040014070400140704001407041013070420140704201407042014
07041015070400150704101507041014070410140704001507041014070400150704101507041015070410140704101407041014070410150704101407041014070410140704101407041014070410140704101507040014070400140704001407040014070400140704001407040014070400140704001407040014070400140704001407040014070400140704001407042011070400110704001207040012
07041014070410140704101407040015070410140704101407041015070410150704101407041015070410140704101507041014070410140704101407041014070410140704101407041014070410140704101407040014070400140704001407040014070400140704001407040014070400140704001407040014070400140704001407040014070400140704001407040015070400150704001507040015
07041014070410150704101407041014070410140704101407041014070410140704001507041015070410140704101507041015070410150704101407041014070410140704101407041014070410150704101507040014070400140704001407040014070400140704001407040014070400140704001407040014070400140704001407040014070400140704001407040015070400150704001507040015
07040015070400150704101407040015070400150704101507040015070400150704101407041014070410140704001507040015070400150704101407041014070410140704101407041014070400150704001507040014070400140704001407040014070400140704001407040014070400140704001407040014070400140704001407040014070400140704001407040015070400150704001507040015
07043011070430110704301107043011070430110704301107043011070430110704301107043011070410120704001507040015070400150704101107043012070430120704301207043012070430120704101207040014070400140704001407040014070400140704001407040014070400140704001407040014070400140704001407040014070400140704001407041011070430110704301207043012
07042014070420150704201407043014070420140704301407042015070420140704201507042014070420100704001507040015070400150704201307042015070420150704201507042015070420150704101007040014070400140704001407040014070400140704001407040014070400140704001407040014070400140704001407040014070400140704001407041013070430150704301507043015
07043014070420140704301407042014070420150704201407043014070420140704201407042015070410100704001507040015070400150704201307043014070420150704301407042014070420150704101007040014070400140704001407040014070400140704001407040014070400140704001407040014070400140704001407040014070400140704001407041013070430150704201507043015
07042014070420140704201407042014070420140704201407042014070420140704201407042014070420100704101507040015070400150704201307042015070420150704301407043014070420150704101007040014070400140704001407040014070400140704001407040014070400140704001407040014070400140704001407040014070400140704001407041013070430150704301507043015
07042014070420140704201407042014070420140704201407042014070420140704201407043014070430100704301107043011070430110704301307042015070430140704201507042015070420150704101007040014070400140704001407040014070400140704001407040014070400140704001407040014070400140704001407040014070400140704001407041013070420150704301407043015
07042014070420140704201407042014070420140704201407042014070420140704201407042014070420150704201507042015070420150704201507042015070420150704301407042015070420150704101007040014070400140704001407040014070400140704001407040014070400140704001407040014070400140704001407040014070400140704001407041013070420150704201507043015
07042014070420140704201407042014070420140704201407042014070420140704201407042014070420150704201507042015070420150704201507042014070420150704201407042015070420150704101007040014070400140704001407040014070400140704001407040014070400140704001407040014070400140704001407040014070400140704001407042013070430150704301407043015
07042014070420140704201407042014070420140704201407042014070420140704201407042015070420150704201507042015070420150704201507042015070420150704201507042015070420150704201007040014070400150704001407040014070400140704001407040015070400150704001507040015070400150002205500022056000220570704001507042013070430150704201507043014
07042014070420140704201407042014070420140704201407042014070420140704201407042014020190180201902002019020020190200201902107042015070420150704201507042015070420150704301007043011070430110704301107043011070430110704301107043011070430110704301107043011070430110002305500023056000230570704301107043013070430150704201507043014
07042014070420140704201407042014070420140704201407042014070420140704201407042014020200180202002002020020020200200202002107042014070420150704201507042015070420150704201507042015070420150704201507042015070420150704201507043015070430150704301507043015070430150704201507043015070430150704301507042015070420150704301407043015
07042014070420140704201407042014070420140704201407042014070420140704201407042014020200180202002002020020020200200202002107042015070420150704201507042015070420150704201507042015070420140704201507042015070420150704201507043014070430150704301507042015070430150704201407043015070420150704201507042015070430150704201507043015
07042014070420140704201407042014070420140704201407042014070420140704201407042014020200180202002002020020020200200202002107042015070420150704201507042015070420150704201507042015070420150704201407042015070420150704201507043015070430150704301407002014070020140700201407043015070430140704301507043015070430140704301407043015
07042014070420140704201407042014070420140704201407042014070420140704201407042014020200180202002002020020020200200202002107042015070420150704201507042015070420150704201507042015070420150704201507042015070420150704201507043015070420150704301507002014070010150700201407042015070430140704201507042015070430150704301507043015
07042014070420140704201407042014070420140704201407042014070420140704201407042014020200180202002002020020020200200202002107042014070420150704201502007019070420150704201407042015070420150704201507042014070420150704201507043015070430150704301507001015070010150700101507042015070430150704201507043015070430150704301507043015
07042014070420140704201407042014070420140704201407042014070420140704201407042014020200180202002002020020020200200202002107042015070420150704201407042015070420150704201507042015070420150704201507042015070420150704201507043015070420150704301407001015070010150700101507043014070420150704201507042015070430150704301407043015
07042014070420140704201407042014070420140704201407042014070420140704201407042014020200180202002002020020020200200202002107042015070420150704201507042015020070190704201507042015070420150704201507042015070420150200701907043015070430150704301507001015070010150700101507043014070430150704301507043014070430150704301407042015
