40
40
000-10-1000-10-1000-10-1000-10-1000-10-1000-10-1000-10-1000-10-1020-10-1020-10-1020-10-1020-10-1020-10-1020-10-1020-10-1020-10-1020-10-1020-10-1020-10-1020-10-1020-10-1020-10-1020-10-1020-10-1020-10-1020-10-1020-10-1020-10-1020-10-1020-10-1020-10-1020-10-1020-10-1020-10-1020-10-1020-10-1020-10-1020-10-1020-10-1020-10-1
000-10-1000-10-1000-10-1000-10-1000-10-1000-10-1000-10-1000-10-1020-10-1020-10-1020-10-1020-10-1020-10-1020-10-1020-10-1020-10-1020-10-1020-10-1020-10-1020-10-1020-10-1020-10-1020-10-1020-10-1020-10-1020-10-1020-10-1020-10-1020-10-1020-10-1020-10-1020-10-1020-10-1020-10-1020-10-1020-10-1020-10-1020-10-1020-10-1020-10-1
000-10-1000-10-1000-10-1000-10-1000-10-1000-10-1000-10-1000-10-1020-10-1020-10-1020-10-1020-10-1020-10-1020-10-1020-10-1020-10-1020-10-1020-10-1020-10-1020-10-1020-10-1020-10-1020-10-1020-10-1020-10-1020-10-1020-10-1020-10-1020-10-1020-10-1020-10-1020-10-1020-10-1020-10-1020-10-1020-10-1020-10-1020-10-1020-10-1020-10-1
000-10-1000-10-1000-10-1000-10-1000-10-1020-10-1000-10-1000-10-1020-10-1020-10-1020-10-1020-10-1020-10-1020-10-1020-10-1020-10-1020-10-1020-10-1020-10-1020-10-1020-10-1020-10-1020-10-1020-10-1020-10-1020-10-1020-10-1020-10-1020-10-1020-10-1020-10-1020-10-1020-10-1020-10-1020-10-1020-10-1020-10-1020-10-1020-10-1020-10-1
000-10-1000-10-1000-10-1000-10-1000-10-1020-10-1000-10-1020-10-1000-10-1020-10-1020-10-1020-10-1020-10-1020-10-1020-10-1020-10-1020-10-1020-10-1020-10-1020-10-1020-10-1020-10-1020-10-1020-10-1020-10-1020-10-1020-10-1020-10-1020-10-1020-10-10703301907033020020-10-1020-10-1020-10-1020-10-1020-10-1020-10-1020-10-1020-10-1
000-10-1000-10-1000-10-1020-10-1000-10-1020-10-1020-10-1000-10-1020-10-1020-10-1020-10-1020-10-1020-10-1020-10-1020-10-1020-10-1020-10-1020-10-1020-10-1020-10-1020-10-1020-10-1020-10-1020-10-1020-10-1020-10-1020-10-1020-10-1020-10-1020-10-10703401907034020020-10-1020-10-1020-10-1020-10-1020-10-1020-10-1020-10-1020-10-1
000-10-1000-10-1000-10-1000-10-1020-10-1000-10-1000-10-1020-10-1020-10-1020-10-1020-10-1020-10-1020-10-1020-10-1020-10-1020-10-1020-10-1020-10-1020-10-1020-10-1020-10-1020-10-1020-10-1020-10-1020-10-1020-10-1020-10-1020-10-1020-10-1020-10-1020-10-1020-10-1020-10-1020-10-1020-10-1020-10-1020-10-1020-10-1020-10-1020-10-1
000-10-1000-10-1000-10-1000-10-1000-10-1000-10-1020-10-1020-10-1020-10-1020-10-1020-10-1020-10-1020-10-1020-10-1020-10-1020-10-1020-10-1020-10-1020-10-1020-10-1020-10-1020-10-1020-10-1020-10-1020-10-1020-10-1020-10-1020-10-1020-10-1020-10-1020-10-1020-10-1020-10-1020-10-1020-10-1020-10-1020-10-1070-10-1070-10-1070-10-1
000-10-1000-10-1000-10-1000-10-1000-10-1000-10-1020-10-1020-10-1020-10-1020-10-1020-10-1020-10-1020-10-1020-10-1020-10-1020-10-1020-10-1020-10-1020-10-1020-10-1020-10-1020-10-1020-10-1020-10-1020-10-1020-10-1020-10-1020-10-1020-10-1020-10-1020-10-1020-10-1020-10-1020-10-1020-10-1020-10-1020-10-1070-10-1070-10-1070-10-1
000-10-1000-10-1000-10-1000-10-1000-10-1000-10-1000-10-1020-10-1020-10-1020-10-1020-10-1020-10-1020-10-1020-10-10003303400033035000330360003303700033038020-10-1020-10-1020-10-1020-10-1020-10-1020-10-1020-10-1070-10-1070-10-1070-10-1070-10-1070-10-1070-10-1070-10-1070-10-1070-10-1070-10-1070-10-1070340190703402007034019
000-10-1000-10-1000-10-1000-10-1000-10-1020-10-1020-10-1020-10-1020-10-1020-10-1020-10-1020-10-1020-10-1020-10-10003403400034035000340360003403700034038020-10-1020-10-1020-10-1020-10-1020-10-1020-10-1020-10-1070-10-1070-10-1070-10-1070-10-10404206704042068040420690404207004042071070-10-1070-10-1070-10-1070-10-1070-10-1
000-10-1000-10-1000-10-1000-10-1000-10-1000-10-1020-10-1020-10-1020-10-1020-10-1040620470406204804062049040620500003503400035035000350360003503700035038020-10-1020-10-1020-10-1020-10-1020-10-1020-10-1020-10-1070-10-1040430640404306504043066040430670404306804043069040430700404307104043072070-10-1070340190703402007034019
000-10-1000-10-1000-10-1000-10-1000-10-1000-10-1020-10-1020-10-1020-10-1020-10-1040630470406304804063049040630500003603400036035000360360003603700036038000-10-1020-10-1020-10-1020-10-1020-10-1020-10-1020-10-1070-10-1040440640404406504044066040440670404406804044069040440700404407104044072070-10-1070-10-1070-10-1070-10-1
000-10-1000-10-1000-10-1000-10-1000-10-1020-10-1020-10-1020-10-1020-10-1020-10-1040640470406404804064049040640500003703400037035000370360003703700037038020-10-1020-10-1020-10-1020-10-1020-10-1020-10-1020-10-1070-10-1040450640404506504045066040450670404506804045069040450700404507104045072070-10-1070340190703402007034019
000-10-1000-10-1000-10-1000-10-1000-10-1020-10-1020-10-1020-10-1020-10-1020-10-1070-10-1070-10-1070-10-1070-10-1070-10-1070-10-1070-10-1070-10-1070-10-1020-10-1020-10-1020-10-1020-10-1020-10-1020-10-1020-10-1070-10-10404606404046065040460660404606704046068070-10-1070-10-10404607104046072070-10-1070-10-1070-10-1070-10-1
000-10-1000-10-1000-10-1000-10-1000-10-1000-10-1020-10-1020-10-1020-10-1020-10-1020-10-1020-10-1020-10-1020-10-1020-10-1020-10-1020-10-1020-10-1020-10-1020-10-1020-10-1020-10-1020-10-1020-10-1020-10-1020-10-1070-10-1070-10-1070-10-1070-10-1070-10-1070-10-1070-10-1070-10-1070-10-1070-10-1020-10-1070340190703402007034019
000-10-1000-10-1000-10-1000-10-1020-10-1020-10-1020-10-1020-10-1020-10-1020-10-1020-10-1020-10-1020-10-1020-10-1020-10-1020-10-1020-10-1020-10-1020-10-1020-10-1020-10-1020-10-1020-10-1020-10-1020-10-1020-10-1020-10-1070-10-1070-10-1070-10-1070-10-1070-10-1070-10-1070-10-1070-10-1020-10-1020-10-1020-10-1070-10-1020-10-1
000-10-1000-10-1000-10-1000-10-1000-10-1020-10-1000-10-1000-10-1020-10-1020-10-1020-10-1020-10-1020-10-1020-10-1020-10-1020-10-1020-10-1020-10-1020-10-1020-10-1020-10-1020-10-1020-10-1020-10-1020-10-1020-10-1020-10-1020-10-1020-10-1020-10-1020-10-1020-10-1020-10-1020-10-1020-10-1020-10-1020-10-1070340190703402007034019
000-10-1000-10-1000-10-1000-10-1020-10-1000-10-1020-10-1020-10-1020-10-1020-10-1020-10-1020-10-1020-10-1020-10-1020-10-1020-10-1020-10-1020-10-1020-10-1020-10-1020-10-1020-10-1000010600000106100001062000-10-1020-10-1000010650000106600001067020-10-1020-10-1000010700000107100001072020-10-1020-10-1020-10-1020-10-1020-10-1
000-10-1000-10-1000-10-1020-10-1000-10-1000-10-1020-10-1020-10-1020-10-1020-10-1020-10-1020-10-1020-10-1020-10-1020-10-1020-10-1020-10-1020-10-1020-10-1020-10-1020-10-1000020590000206000002061000020620000206300002064000020650000206600002067000020680000206900002070000020710000207200002073020-10-1020-10-1020-10-1020-10-1
000-10-1000-10-1000-10-1000-10-1000-10-1020-10-1020-10-1020-10-1020-10-1020-10-1020-10-1020-10-1020-10-1020-10-1020-10-100004008000040090000401000004011020-10-10000305800003059000030600000306100003062000030630000306400003065000030660000306700003068000030690000307000003071000030720000307300003074020-10-1020-10-1020-10-1
020-10-1020-10-1000-10-1000-10-1000-10-1020-10-1020-10-1020-10-1020-10-1020-10-1020-10-1020-10-1020-10-1020-10-1020-10-100005008000050090000501000005011020-10-100004058020-10-1020-10-1020-10-1020-10-1020-10-1020-10-1020-10-1020-10-1020-10-1020-10-1020-10-1020-10-1020-10-1020-10-1020-10-100005074020-10-1020-10-1020-10-1
000-10-1000-10-1000-10-1020-10-1020-10-1020-10-1020-10-1020-10-1020-10-1020-10-1020-10-1020-10-1020-10-1020-10-1020-10-100006008000060090000601000006011020-10-100004058020-10-1020-10-1020-10-1020-10-1020-10-1020-10-1020-10-1020-10-1020-10-1020-10-1020-10-1020-10-1020-10-1020-10-1020-10-100005074020-10-1020-10-1020-10-1
020-10-1020-10-1000-10-1020-10-1020-10-1020-10-1020-10-1020-10-1020-10-1020-10-1020-10-1020-10-1020-10-1020-10-1020-10-1020-10-1020-10-1020-10-1020-10-1020-10-100004058020-10-1020-10-1020-10-1020-10-1020-10-1020-10-1020-10-1020-10-1020-10-1020-10-1020-10-1020-10-1020-10-1020-10-1020-10-100005074020-10-1020-10-1020-10-1
020-10-1020-10-1020-10-1020-10-1020-10-1020-10-1020-10-1020-10-1020-10-1020-10-1020-10-1020-10-1020-10-1020-10-1020-10-1020-10-1020-10-1020-10-1020-10-1020-10-100004058020-10-1020-10-1020-10-1020-10-1020-10-1020-10-1020-10-1020-10-1020-10-1020-10-1020-10-1020-10-1020-10-1020-10-1020-10-100005074020-10-10702702407027025
02024005020240060202400502024006020240050202400602024005020240060202400502024006020-10-1020-10-1020-10-1020-10-1020-10-1020-10-1020-10-1020-10-1020-10-1020-10-100004058020-10-1020-10-1020-10-1020-10-1020-10-1020-10-1020-10-1020-10-1020-10-1020-10-1020-10-1020-10-1020-10-1000-10-1000-10-100005074070280230702802407028025
020-10-1020-10-1020-10-1020-10-1020-10-1020-10-1020-10-1020-10-1020-10-1020-10-1020-10-1020-10-1020-10-1020-10-1020-10-1020-10-1020-10-1020-10-1020-10-1020-10-100004058020-10-1020-10-1020-10-1020-10-1020-10-1020-10-1020-10-1020-10-1020-10-1020-10-1020-10-1020-10-1020-10-1020-10-1000-10-100005074070290230702902407029025
020-10-1020-10-1020-10-10702702007027021020-10-1020-10-1020-10-1020-10-1020-10-1020-10-1070-10-1020-10-1020-10-1020-10-1020-10-1020-10-1020-10-1020-10-1020-10-100010058020-10-1020-10-1020-10-1020-10-1020-10-1000-10-1000-10-1000-10-1000-10-1000-10-1020-10-1020-10-1020-10-1020-10-1000-10-100010074070300230703002407030025
020-10-1020-10-1070280190702802007028021020-10-1020-10-1020-10-1020-10-1020-10-1020-10-1020-10-1020-10-1020-10-1020-10-1020-10-1020-10-1020-10-1020-10-1020-10-10001105800011059000110600001106000011060000110600001106000011060000110600001106000011060000110600001106000011060000110600001107300011074070160230701602407016025
020-10-1020-10-107029019070290200702902107029022020-10-1020-10-102006007020-10-1020-10-1020-10-1020-10-1020-10-1020-10-1020-10-1020-10-1020-10-1020-10-1020-10-1020-10-1020-10-1020-10-1020-10-1020-10-1020-10-1020-10-1020-10-1020-10-1020-10-1020-10-1020-10-1020-10-1020-10-1020-10-1020-10-1020-10-1070170230701702407017025
020-10-1020-10-1020-10-10703002007030021020-10-1020-10-1020-10-102007007020-10-1020-10-1020-10-1020-10-1020-10-1020-10-1020-10-1020-10-1020-10-1020-10-1020-10-1020-10-1020-10-1020-10-1020-10-1020-10-1020-10-1020-10-1020-10-1020-10-1020-10-1020-10-1020-10-1020-10-1020-10-1020-10-1020-10-1020-10-1020-10-10701802407018025
020-10-1020-10-1020-10-1020-10-1020-10-1020-10-1020-10-1020-10-102007007020-10-1020-10-1020-10-1020-10-1020-10-1020-10-1020-10-102006007020-10-1020-10-1020-10-1020-10-1020-10-1020-10-1020-10-1020-10-1020-10-1020-10-1020-10-1020-10-1020-10-1020-10-1020-10-1020-10-1020-10-1020-10-1020-10-1020-10-1020-10-1020-10-1020-10-1
020-10-1020-10-1020-10-1020-10-1020-10-1020-10-1020-10-1020-10-102007007020-10-1020-10-1020-10-1020-10-1020-10-1020-10-1020-10-102007007020-10-1020-10-1020-10-1020-10-1020-10-1020-10-1020-10-1020-10-1020-10-1020-10-1020-10-1020-10-1020-10-1020-10-1020-10-1020-10-1020-10-1020-10-1020-10-1020-10-1020-10-1020-10-1020-10-1
020-10-1020-10-1020-10-1020-10-1020-10-1020-10-1020-10-1020-10-102007007020-10-1020-10-1020-10-1020-10-1020-10-1020-10-1020-10-102007007020-10-1020-10-1020-10-1020-10-1020-10-1020-10-1020-10-1020-10-1020-10-1020-10-1020-10-1020-10-1020-10-1020-10-1020-10-1020-10-1020-10-1020-10-1020-10-1020-10-1020250010202500202025001
020-10-1020-10-1020-10-1020-10-1020-10-1020-10-1020-10-1020-10-102007007020-10-1020-10-1020-10-1020-10-1020-10-1020-10-1020-10-1020070070900000509000006090000070900000609000007090000060900000709000006090000070900000809000009020-10-1020-10-1020-10-1020-10-1020-10-1020-10-1020-10-10202500102025002020250010202500202025001
020-10-1020-10-1020-10-1020-10-1020-10-1020-10-1020-10-1020-10-102007007020-10-1020-10-1020-10-1020-10-1020-10-1020-10-1020-10-1020070070900100509001006090010070900100609001007090010060900100709001006090010070900100809001009020-10-1020-10-1020-10-1020-10-1020-10-1020-10-1020-10-10202500102025002020250010202500202025001
020-10-1020-10-1020-10-1020-10-1020-10-1020-10-1020-10-1020-10-102007007020-10-1020-10-1020-10-1020-10-1020-10-1020-10-1020-10-1020070070900200509002006090020070900200609002007090020060900200709002006090020070900200809002009020-10-1020-10-1020-10-1020-10-1020-10-1020-10-1020-10-10202500102025002020250010202500202025001
020-10-1020-10-1020-10-1020-10-1020-10-1020-10-1020-10-1020-10-102007007020-10-1020-10-1020-10-1020-10-1020-10-1020-10-1020-10-1020070070900100509001006090010070900100609001007090010060900100709001006090010070900300809003009020-10-1020-10-1020-10-1020-10-1020-10-1020-10-1020-10-10202500102025002020250010202500202025001
020-10-1020-10-1020-10-1020-10-1020-10-1020-10-1020-10-1020-10-102007007020-10-1020-10-1020-10-1020-10-1020-10-1020-10-1020-10-1020070070900200509002006090020070900200609002007090020060900200709002006090020070900200809002009020-10-1020-10-1020-10-1020-10-1020-10-1020-10-1020-10-10202500102025002020250010202500202025001
020-10-1020-10-1020-10-1020-10-1020-10-1020-10-1020-10-1020-10-1020-10-1020-10-1020-10-1020-10-1020-10-1020-10-1020-10-1020-10-1020-10-10900100509001006090030070900300609003007090030060900300709003006090030070900300809003009020-10-1020-10-1020-10-1020-10-1020-10-1020-10-1020-10-1020-10-1020-10-1020-10-1020-10-1020-10-1
