40
40
0000000000000110000100000110001000001100
0100000001000110000100000110000001101100
0001100000000000100100000110110000000001
0001100000000011000100000110111101000000
0000010000000000000100000110000000000100
0000000000000000000100000111111111110111
1000000111111111111100000111111111111111
0000110100000000000000000000001100000001
0000000100000000000000000000000000000010
0000000100000000000000000000000000000001
0110100100000000000000000000000000000111
0110000100000000000000000000000000000111
0000000100000000000000000000000000000111
0000000100111111111000000000000000000111
0110000100101111011000000000111111100111
0110000100000001010000000000111111100111
0000000100000000000000000000001010000111
0000000100000000000000000000000000000111
1111111100000000000000000000000000000111
0000000000000000000000000000000000000111
0000000000000000000000000000000000000000
0000000000000001001001111111111111110000
0000000000000001111001111111111111110000
0000000000000001011001111111111111110000
0000000000000000000001111111111111110000
0000000000000000000001111111111111110001
1111111111000000000001111111111111110011
1111111111000000000001111111111111110011
1100000000000000000001111111111111110001
1101100000000000000001111110001111110011
1101100010000000000001111110001111110011
1100000010000000000000000000000000000011
1111111110000000100000000000000000000011
1111111110000000100000000000000000011001
1111111110000000100000000000000000011111
1111111110000000100000000000000000011111
1111111110000000100000000000000000011111
1111111110000000100000000000000000011111
1111111110000000100000000000000000011111
1111111110000000100000000000000000011111
