40
40
021001021002021001021002021001021002021001021002021001021002021001021002021001021002021309021411021312021001021002021001021002021001021002021001021002020000020000020000020000020000020000020000020000020000020000020000020000020000020000020000
021101021102021101021102021101021102021101021102021101021102021101021102021101021102021309021411021312021101021102021101021102021101021102021101021102020000020000020000020000020000020000020000020000020000020000020000020000020000020000020000
021001021002021209021210021210021210021210021210021210021210021210021210021210021210021609021411021610021211021211021211021211021211021212021001021002020000020000020000020000020000020000020000020000020000020000020000020000020000020000020000
021101021102021409021411021918021919021919021919021919021919021919021921021411021411021411021411021411021411021411021411021411021411021312021101021102020000020000020000020000020000020000020000020000020000020000020000020000020000020000020000
021001021002021409021411022018022019022019022019022019022019022019022021021411021411021411021918021919021919021919021919021919021921021312021001021002020000020000020000020000020000020000020000020000020000020000020000020000020000020000020000
021101021102021409021411022018022019022019022019022019022019022019022021021411021411021411022018022020022020022020022020022020022021021312021101021102020000020000020000020000020000020000020000020000020000020000020000020000020000020000020000
021001021002021409021411022018022019022019022019022019022019022019022021021411021411021411022018022020022020022020022020022020022021021312021001021002020000020000020000020000020000020000020000020000020000020000020000020000020000020000020000
021101021102021409021411022018022019022019022019022019022019022019022021021411021411021411022018022020022020022020022020022020022021021312021101021102020000020000020000020000020000020000020000020000020000020000020000020000020000020000020000
021001021002021409021411022218022220022220022220022220022220022220022221021411021411021411022018022020022020022020022020022020022021021312021001021002020000020000020000020000020000020000020000020000020000020000020000020000020000020000020000
021101021102021409021411021411021411021411021411021411021411021411021411021411021411021411022018022020022020022020022020022020022021021312021101021102020000020000020000020000020000020000020000020000020000020000020000020000020000020000020000
021001021002021409021411021411021411021813021816021411021411021411021411021411021411021411022018022020022020022020022020022020022021021312021001021002020000020000020000020000020000020000020000020000020000020000020000020000020000020000020000
021101021102021409021411021411021813022213021916021411021411021411021411021411021411021411022218022220022220022220022220022220022221021312021101021102020000020000020000020000020000020000020000020000020000020000020000020000020000020000020000
021001021002021409021411021813022213022314022116021411021411021411021411021411021411021411021411021411021411021411021813021816021411021312021001021002020000020000020000020000020000020000020000020000020000020000020000020000020000020000020000
021101021102021409021411021913021915022016021411021411021411021411021411021411021411021411021411021813021814021816021913021916021411021312021101021102020000020000020000020000020000020000020000020000020000020000020000020000020000020000020000
021001021002021409021411022113022114022116021411021411021411021411021411021411021411021411021411021913021914022214022213022214021816021312021001021102020000020000020000020000020000020000020000020000020000020000020000020000020000020000020000
021101021102021409021411021411021411021411021411021411021411021411021411021411021411021411021411022113022114022114022114022115022116021312021101021102020000020000020000020000020000020000020000020000020000020000020000020000020000020000020000
021001021002021509021510021510021510021510021510021510021510021511021511021511021511021511021511021511021511021511021511021511021511021512021001021102020000020000020000020000020000020000020000020000020000020000020000020000020000020000020000
021101021101020411020412020000020000020411020000020000020000020000020000020412020000020000020000020000020000020000020411020000020000020000021101021102020000020000020000020000020000020000020000020000020000020000020000020000020000020000020000
021001021002020511020512020000020411020000020000020511020000020412020000020512020000020000020000020411020000020000020511020000020000020412021001021102020000020000020000020000020000020000020000020000020000020000020000020000020000020000020000
021101021102020000020511020000020412020000020511020000020411020512020000020511020411020000020412020000020000020511020000020412020000020512021101021102020000020000020000020000020000020000020000020000020000020000020000020000020000020000020000
020008020008020008020008020008020008020008020008020008020008020008020008020008020008020008020008020008020008020008020008020008020008020008020008020008020000020000020000020000020000020000020000020000020000020000020000020000020000020000020000
020000020000020000020000020000020000020000020000020000020000020000020000020000020000020000020000020000020000020000020000020000020000020000020000020000020000020000020000020000020000020000020000020000020000020000020000020000020000020000020000
020000020000020000020000020000020000020000020000020000020000020000020000020000020000020000020000020000020000020000020000020000020000020000020000020000020000020000020000020000020000020000020000020000020000020000020000020000020000020000020000
020000020000020000020000020000020000020000020000020000020000020000020000020000020000020000020000020000020000020000020000020000020000020000020000020000020000020000020000020000020000020000020000020000020000020000020000020000020000020000020000
020000020000020000020000020000020000020000020000020000020000020000020000020000020000020000020000020000020000020000020000020000020000020000020000020000020000020000020000020000020000020000020000020000020000020000020000020000020000020000020000
020000020000020000020000020000020000020000020000020000020000020000020000020000020000020000020000020000020000020000020000020000020000020000020000020000020000020000020000020000020000020000020000020000020000020000020000020000020000020000020000
020000020000020000020000020000020000020000020000020000020000020000020000020000020000020000020000020000020000020000020000020000020000020000020000020000020000020000020000020000020000020000020000020000020000020000020000020000020000020000020000
020000020000020000020000020000020000020000020000020000020000020000020000020000020000020000020000020000020000020000020000020000020000020000020000020000020000020000020000020000020000020000020000020000020000020000020000020000020000020000020000
020000020000020000020000020000020000020000020000020000020000020000020000020000020000020000020000020000020000020000020000020000020000020000020000020000020000020000020000020000020000020000020000020000020000020000020000020000020000020000020000
020000020000020000020000020000020000020000020000020000020000020000020000020000020000020000020000020000020000020000020000020000020000020000020000020000020000020000020000020000020000020000020000020000020000020000020000020000020000020000020000
020000020000020000020000020000020000020000020000020000020000020000020000020000020000020000020000020000020000020000020000020000020000020000020000020000020000020000020000020000020000020000020000020000020000020000020000020000020000020000020000
020000020000020000020000020000020000020000020000020000020000020000020000020000020000020000020000020000020000020000020000020000020000020000020000020000020000020000020000020000020000020000020000020000020000020000020000020000020000020000020000
020000020000020000020000020000020000020000020000020000020000020000020000020000020000020000020000020000020000020000020000020000020000020000020000020000020000020000020000020000020000020000020000020000020000020000020000020000020000020000020000
020000020000020000020000020000020000020000020000020000020000020000020000020000020000020000020000020000020000020000020000020000020000020000020000020000020000020000020000020000020000020000020000020000020000020000020000020000020000020000020000
020000020000020000020000020000020000020000020000020000020000020000020000020000020000020000020000020000020000020000020000020000020000020000020000020000020000020000020000020000020000020000020000020000020000020000020000020000020000020000020000
020000020000020000020000020000020000020000020000020000020000020000020000020000020000020000020000020000020000020000020000020000020000020000020000020000020000020000020000020000020000020000020000020000020000020000020000020000020000020000020000
020000020000020000020000020000020000020000020000020000020000020000020000020000020000020000020000020000020000020000020000020000020000020000020000020000020000020000020000020000020000020000020000020000020000020000020000020000020000020000020000
020000020000020000020000020000020000020000020000020000020000020000020000020000020000020000020000020000020000020000020000020000020000020000020000020000020000020000020000020000020000020000020000020000020000020000020000020000020000020000020000
020000020000020000020000020000020000020000020000020000020000020000020000020000020000020000020000020000020000020000020000020000020000020000020000020000020000020000020000020000020000020000020000020000020000020000020000020000020000020000020000
020000020000020000020000020000020000020000020000020000020000020000020000020000020000020000020000020000020000020000020000020000020000020000020000020000020000020000020000020000020000020000020000020000020000020000020000020000020000020000020000
