24
60
020000020000020000020000020000020000020000020000020000020000020109020110020110020112020000020000020000020000020000020000020000020000020000020000
020000020000020000020000020000020000020000020000020000020000020109020110020110020112020000020000020000020000020000020000020000020000020000020000
020000020000020000020000020000020000020000020000020000020000020109020110020110020112020000020000020000020000020000020000020000020000020000020000
020000020000020000020000020000020000020000020000020000020000020209020111020111020410020011020011020011020011020011020011020011020012020000020000
020000020000020000020000020000020000020000020000020000020000020209020111020111020111020111020111020111020111020111020111020111020112020000020000
020000020000020000020000020000020000020000020000020000020000020209020111020111020111020111020111020111020111020111020111020111020112020000020000
020000020000020000020000020000020000020000020000020000020000020309020310020310020310020310020310020509020211020211020111020111020212020000020000
020000020000020000020000020000020000020000020000020000020000020000020000020000020000020000020000020109020211020211020111020111020212020000020000
020000020000020000020000020000020000020000020000020000020000020000020000020000020000020000020000020309020311020311020310020310020312020000020000
020000020000020000020000020000020000020000020000020000020000020000020000020000020000020000020000020000020000020000020000020000020000020000020000
020000020000020000020000020000020000020000020000020000020000020000020000020000020000020000020000020000020000020000020000020000020000020000020000
020000020000020000020000020000020000020000020000020000020000020000020000020000020000020000020000020000020000020000020000020000020000020000020000
020000020000020000020000020000020000020000020000020000020000020000020000020000020000020000020000020000020000020000020000020000020000020000020000
020000020000020000020000020000020000020000020000020000020000020000020000020000020000020000020000020000020000020000020000020000020000020000020000
020000020000020000020000020000020000020000020000020000020000020000020000020000020000020000020000020009020011020011020011020011020012020000020000
020000020000020000020000020000020000020000020000020000020000020000020000020000020000020000020000020109020211020211020211020211020112020000020000
020000020000020000020000020000020000020000020009020011020011020011020011020011020011020011020011020409020211020211020211020211020112020000020000
020000020000020000020000020000020000020000020109020111020111020111020111020111020111020111020111020111020111020111020111020111020112020000020000
020000020000020000020000020000020000020000020109020111020111020111020111020111020111020111020111020111020111020111020111020111020112020000020000
020000020000020000020000020000020000020000020109020111020111020510020311020311020311020311020311020311020311020311020311020311020312020000020000
020000020000020000020000020000020000020000020109020111020111020112020000020000020000020000020000020000020000020000020000020000020000020000020000
020000020000020000020000020000020000020000020309020311020311020312020000020000020000020000020000020000020000020000020000020000020000020000020000
020000020000020000020000020000020000020000020511020000020412020000020000020000020000020411020009020011020011020011020011020011020012020000020000
020000020000020000020000020000020000020000020000020000020512020511020000020511020412020000020109020211020211020211020211020211020112020000020000
020000020000020000020000020000020000020000020511020411020000020411020411020000020512020009020409020211020211020211020211020211020112020000020000
020000020000020000020000020000020000020000020000020000020000020000020000020411020000020309020310020310020310020509020211020211020212020000020000
020000020000020000020000020000020000020000020000020000020000020000020000020000020000020000020000020000020000020209020110020110020112020000020000
020000020000020000020000020000020000020000020000020000020000020000020000020000020000020000020000020000020000020209020110020110020112020000020000
020000020000020000020000020000020000020000020000020000020000020000020000020000020000020000020000020000020000020209020110020110020112020000020000
020000020000020000020000020000020000020000020000020000020000020000020000020000020000020000020000020000020000020209020110020110020112020000020000
020000020000020000020000020000020000020000020000020000020000020000020000020000020000020000020000020000020000020209020110020110020112020000020000
020000020000020000020000020000020000020000020000020000020000020000020000020000020000020000020000020000020000020209020110020110020112020000020000
020000020000020009020010020010020010020010020010020010020010020010020010020010020010020010020010020010020010020409020110020110020112020000020000
020000020000020309020310020310020509020211020110020110020110020110020110020110020110020110020110020110020110020110020110020110020112020000020000
020000020000020000020511020411020209020211020110020110020110020110020110020110020110020110020110020110020110020110020110020110020112020000020000
020000020000020511020009020011020409020510020311020311020311020311020311020311020311020311020311020311020311020311020311020311020312020000020000
020000020000020009020409020111020111020212020000020000020000020000020000020000020000020000020000020000020000020000020000020000020000020000020000
020000020000020109020510020310020509020212020000020000020000020000020000020000020000020000020000020000020000020000020000020000020000020000020000
020000020000020109020112020412020109020212020000020000020000020000020000020000020000020000020000020000020000020000020000020000020000020000020000
020000020000020109020112020512020109020212020000020000020000020000020000020000020000020000020000020000020000020000020000020000020000020000020000
020000020000020109020410020011020409020212020000020000020000020000020000020000020000020000020000020000020000020000020000020000020000020000020000
020000020000020309020310020310020310020312020000020000020000020000020000020000020000020000020000020000020000020000020000020000020000020000020000
020000020000020000020000020000020000020000020000020000020000020000020000020000020000020000020000020000020000020000020000020000020000020000020000
020000020000020000020000020000020000020000020000020000020000020000020000020000020000020000020000020000020000020000020000020000020000020000020000
020000020000020000020000020000020000020000020000020000020000020000020000020000020000020000020000020000020000020000020000020000020000020000020000
020000020000020000020000020000020000020000020000020000020000020000020000020000020000020000020000020000020000020000020000020000020000020000020000
020000020000020000020000020000020000020000020000020000020000020000020000020000020000020000020000020000020000020000020000020000020000020000020000
020000020000020000020000020000020000020000020000020000020000020000020000020000020000020000020000020000020000020000020000020000020000020000020000
020000020000020009020010020010020010020012020000020000020000020000020000020000020000020000020000020000020000020000020000020000020000020000020000
020000020000020109020111020111020111020112020000020000020000020000020000020000020000020000020000020000020000020000020000020000020000020000020000
020000020000020109020111020111020111020112020000020000020000020000020000020000020000020000020000020000020000020000020000020000020000020000020000
020000020000020109020111020111020111020112020000020000020000020000020000020000020000020000020000020000020000020000020000020000020000020000020000
020000020000020109020211020211020211020410020011020011020011020011020011020011020011020011020011020011020011020011020011020011020012020000020000
020000020000020109020211020211020211020211020211020211020211020111020111020111020111020111020111020111020111020111020111020111020212020000020000
020000020000020109020211020211020211020211020211020211020211020111020111020111020111020111020111020111020111020111020111020111020212020000020000
020000020000020309020310020311020311020311020311020311020311020509020111020111020510020311020311020311020311020311020311020311020312020719020000
020000020000020000020000020000020000020000020000020000020000020109020211020211020112020000021809021810021810021810021810021810021812020000020000
020000020000020000020000020000020000020000020000020000020000020109020211020211020112020000022109022110022110022110022309021911022012020000020000
020000020000020000020000020000020000020000020000020000020000020109020211020211020112020000020000020000020000020000022109022111022112020000020000
020000020000020000020000020000020000020000020000020000020000020109020211020211020112020000020000020000020000020000020000020000020000020000020000
