63
51
021601021602021601021602021601021602021601021602021601021602021601021602021601021602021601021602021601021602021601021602021601021602021601021602021601021602021601021602021601021602020000022018022019022019022019022019022019022019022021020000020000020000020000020000020000020000020000020000020000020000020000020000020000020000020000020000020000020000010401010302010501010302010302
021701021702021701021702021701021702021701021702021701021702021701021702021701021702021701021702021701021702021701021702021701021702021701021702021701021702021701021702021701021702020000022018022019022019022019022019022019022019022021020000020000020000020000020000020000020000020000020000020000020000020000020000020000020000020000020000020000020000010401010302010501010302010302
021601021602021601021602021601021602021601021602021601021602021601021602021601021602021601021602021601021602021601021602021601021602021601021602021601021602021601021602021601021602020000022018022019022019022019022019022019022019022021020000020000020000020000020000020000020000020000020000020000020000020000020000020000020000020000020000020000020000010401010302010501010302010302
021701021702021701021702021701021702021701021702021701021702021701021702021701021702021701021702021701021702021701021702021701021702021701021702021701021702021701021702021701021702020000022018022019022019022019022019022019022019022021020000021701020000021701020000021701020000021701020000021701020000021701020000021701020000021701020000021701020000010401010302010501010302010302
021601021602021601021602020000020000020000020000020000020000020000020000020000020000020000020000020000020000020000020000020000020000020000020000020000020000020000020000020000020000020000022018022019022019022019022019022019022019022021020000020000020000020000020000020000020000020000020000020000020000020000020000020000020000020000020000020000020000010401010302010501010302010302
021701021702021701021702020000020000020000020000020000020000020000020000020000020000020000020000020000020000020000020000020000020000020000020000020000020000020000020000020000020000020000022018022019022019022019022019022019022019022021020000020000020000020000020000020000020000020000020000020000020000020000020000020000020000020000020000020000020000010401010302010501010302010302
021601021602021601021602020000020000020000020000020000020000020000020000020000020000020000020000020000020000020000020000020000020000020000020000020000020000020000020000020000020000020000022018022019022019022019022019022019022019022021020000020000020000020000020000020000020000020000020000020000020000020000020000020000020000020000020000020000020000010401010302010501010302010302
021701021702021701021702020000020000020000020000020000020000020000020000020000020000020000020000020000020000020000020000020000020000020000020000020000020000020000020000020000020000020000022018022019022019022019022019022019022019022021020000020000020000020000020000020000020000020000020000020000020000020000020000020000020000020000020000020000020000010401010302010501010302010302
021601021602021601021602020000020000020000020000021918021919021919021919021919021919021919021919021919021919021919021919021919021919021919021919021919021919021919021919021919021921020000022018022019022019022019022019022019022019022319021920021920021920021920021920021920021920021920021920021920021920021920021920021920021920021921020000020000020000010401010302010501010302010302
021701021702021701021702020000020000020000020000022018022019040533022019022019040536022020040533040533022019040536022020040533022019022019040536022020040533022019022020040536022021020000022018022019022019022019022019022019022019022019022019040533022019022019040536040533040533022019022019040536022019040533022019022019040536022021020000020000020000010401010302010501010302010302
021601021602021601021602020000020000020000020000022018022019040533022019022019040536022020040533040533022019040536022020040533022019022019040536022020040533022019022020040536022121020000022018022019022019022019022019022019022019022019022019040533022019022019040536040533040533022019022019040536022019040533022019022019040536022021020000020000020000010401010302010501010302010302
021701021702021701021702020000020000020000020000022018022019040533022019022019040536022020040533022019022019040536022020040533022019022019040536022020040533022019022020040536022121020000022018022019022019022019022019022019022019022019022019040533022019022019040536040533040533022019022019040536022019040533022019022019040536022021020000020000020000010401010302010501010302010302
021601021602021601021602020000020000020000020000022018022019040533022019022020040536022020040533022019022019040536022020040533022019022019040536022020040533022019022020040536022121020000022018022019022019022019022019022019022019022019022019040533022019022019022019040533040533022020022019040536022019040533022019022019040536022021020000020000020000010401010302010501010302010302
021701021702021701021702020000020000020000020000022018022019041033022020022020041033022020041033022020022020041033022020041033022020022020041033022020041033022020022020041033022121020000022018022020022020022020022020022020022020022020022020022020022020022020022020022020022020022020022020022020022020022019022019022019022019022021020000020000020000010401010302010501010302010302
021601021602021601021602020000020000020000020000022218022219022220022220022220022220022220022220022220022220022220022220022220022220022220022220022220022220022220022220022220022221020000022218022219022219022219022219022219022219022219022219022220022220022220022220022220022220022220022220022220022220022220022220022220022220022221020000020000020000010401010302010501010302010302
021701021702021701021702020000020000020000020000020000020000020000020000020000020000020000020000020000020000020000020000020000020000020000020000020000020000020000020000020000020000020000020000020000020000020000020000020000020000020000020000020000020000020000020000020000020000020000020000020000020000020000020000020000020000020000020000020000020000010401010302010501010302010302
021601021602021601021602020000020000020000020000020000020000020000020000020000020000020000020000020000020000020000020000020000020000020000020000020000020000020000020000020000020000020000020000020000020000020000020000020000020000020000020000020000020000020000020000020000020000020000020000020000020000020000020000020000020000020000020000020000020000010401010302010501010302010302
021701021702021701021702020000020000020000020000021918021919021919021919021919021919021919021919021919021919021919021919021919021919021919021919021919021919021919021919021919021920021920021920021920021920021920021920021920021920021921020000020000021918021920021920021920021920021920021920021920021920021920021920021920021920021921020000020000020000010401010302010501010302010302
021601021602021601021602020000020000020000020000022018022019022019022019022020022020022020022020022020022020004034004034004034004034004034001001001001001001001001001001022020022020022020022020046489022020022020022020022020022020022021020000020000022118022020022020022020022020022020022020022020022020022019022019022019022020022021020000020000020000010401010302010501010302010302
021701021702021701021702020000020000020000020000022018022019022019022019022020000911000911000911000911000911004034022020022020022020022020001001022020022020022020022020022020022020022020022020046989022020022020022020022020022020022021020000020000022118022020022020022020022020022020022020022020022020022019022019022019022020022021020000020000020000010401010302010501010302010302
021601021602021601021602020000020000020000020000022018022019022019022019022020022020022020022020022020000911004034022020022020022020022020001001022020022020022020022020022020022020022020022020046989022020022020022020022020022020022021020000020000022118022020022020022020022020022020022020022020022020022019022019022019022020022021020000020000020000010401010302010501010302010302
021701021702021701021702020000020000020000020000022018022019022019022019022020022020022020022020022020000911004034022020022020022020022020001001022020022020022020022020022020022020022020022020046989022020022020022020022020022020022021020000020000022218022220022220022220022220022220022220022220022220022220022220022220022220022221020000020000020000010401010302010501010302010302
020000020000020000020000020000020000020000020000022018022019022019022019022020022020022020022020022020000911004034022020022020022020022020001001022020022020022020022020022020022020022020022020046989022020022020022020022020022020022021020000020000020000020000020000020000020000020000020000020000020000020000020000020000020000020000020000020000020000010401010302010501010302010302
020000020000020000020000020000020000020000020000022018022019022019022019022020022020022020022020022020022020022020022020022020022020022020022020022020022020022020022020022020022020022020022020046989022020022020022020022020022020022021020000020000020000020000020000020000020000020000020000020000020000020000020000020000020000020000020000020000020000020000010602010602010602010602
021920021920021920021920021920021920021920021920022318022019022019022019022020022020022020022020022020022020022020022020022020022020022020022020022020022020022020022020022020022020022020022019047093047093047093047093047093022020022319021920021920021920021920021920021920021920021920021920021920021920021920021920021920021920021921020000020000020000020000020000020000020000020000
022019022019022019022019022019022019022019022019022019022019022019022019022020022020022020022020022020022020022020022020022020022020022020022020022020022020022020022020022020022020022020047188022020022020022020022020022020022020022020022020022020022020022020022020022020022020022020022020022020022020022019022019022019022020022021020000020000020000020000020000020000020000020000
022019022019022019022019022019022019022019022019022019022019022019001602001608001608001608001608001608001608022019040639022020022020022020040643022020040639022020022020022020040743022020047188022020022020022020022020022020022020022020000621000621000621000621000621022020000621000621000621000621000621022019022019022019022020022021020000020000020000020000020000020000020000020000
022019022019022019022019022019022019022019022019022019022019022019001602022020022020022020022020022020001608022019040639022020022020022020040643022020040639022020022020022020040743022020047188022020022020022020022020022020022020022020000621022020022020022020022020022020000621022020022020022020022020022019022019022019022020022021020000020000020000020000020000020000020000020000
022019022019022019022019022019022019022019022019022019022019022019001602022020022020022020022020022020001608022019040639022020022020022020040643022020040639022020022020022020040743022020047188022020022020022020022020022020022020022020000621022020022020022020022020022020000621022020022020022020022020022019022019022019022020022021020000020000020000020000020000020000020000020000
022019022019022019022019022019022019022019022019022019022019022019001602022020022020022020022020022020001608022019040639022020022020040643040643022020040639022020022020022020040743022020047188022020022020022020022020022020022020022020000621022020022020022020022020022020000621022020022020022020022020022019022019022019022020022021020000020000020000020000020000020000020000020000
022019022019022019022019022019022019022019022019022019022019022019001602022020022020022020022020022020001608022019040639022020022020040643040643022020040639022020022020022020040743022020047188022020022020022020022020022020022020022020000621022020022020022020022020022020000621022020022020022020022020022019022019022019022020022021020000020000020000010401010402010401010302010302
022219022219022219022219022219022219022219022219022418022019022019001602022020022020022020022020022020001608022019040639022020022020040643040643022020040639022020022020022020040743022020047788047788047788047788047788047788047788022020000621022020022020022020022020022020000621022020022020022020022020022019022019022019022020022021020000020000020000010401010402010401010302010302
020000020000020000020000020000020000020000020000022118022019022019022019022020022020022020022020022020022020022020022020022020022020022020022020022020022020022020022020022020022020022020022020022020022020022020022020022020022020022020022020022020022020022020022020022020022020022020022020022020022020022019022019022019022020022021020000020000020000010401010402010401010302010302
021701020000021701020000020000020000020000020000022218022220022220022220022220022220022220022220022220022220022220022220022220022220022220022220022220022220022220022220022220022220022220022220022220022220022220022220022220022220022220022220022220022220022220022220022220022220022220022220022220022220022220022220022220022220022221020000020000020000010401010402010401010302010302
020000020000020000020000020000020000020000020000020000020000020000020000020000020000020000020000020000020000020000020000020000020000020000020000020000020000020000020000020000020000020000020000020000020000020000020000020000020000020000020000020000020000020000020000020000020000020000020000020000020000020000020000020000020000020000020000020000020000010401010402010401010302010302
021701020000021701020000020000020000020000020000020000020000020000020000020000020000020000020000020000020000020000020000020000020000020000020000020000020000020000020000020000020000020000020000020000020000020000020000020000020000020000020000020000020000020000020000020000020000020000020000020000020000020000020000020000020000020000020000020000020000010401010402010401010302010302
020000020000020000020000020000020000020000020000021918021919021919021919021919021919021919021919021919021919021919021919021919021919021919021919021919021919021919021919021919021921020000020000021918021919021919021919021919021919021919021919021919021919021919021919021919021919021919021919021919021919021919021919021919021919021921020000020000020000010401010402010401010302010302
021701020000021701020000020000020000020000020000022018022019040533022019022020040536022020040533022020022020040536022020040533022020022020040536022020040533022020022020040536022021020000020000022118022020022020022020022020022020022020022020040533022020022020040536022020040533022020022020040536022020040533022019022019040536022021020000020000020000010401010402010401010302010302
020000020000020000020000020000020000020000020000022018022019040533022019022020040536022020040533022020022020040536022020040533022020022020040536022020040533022020022020040536022021020000020000022118022020022020022020022020022020022020022020040533022020022020040536022020040533022020022020040536022019040533022019022019040536022021020000020000020000010401010402010401010302010302
021701020000021701020000020000020000020000020000022118022119040533022019022019040536022019040533022019022019040536022019040533022019022019040536022019040533022019022019040536022021020000020000022118022019022019022019022019022019022019022019040533022019022019040536022019040533022019022019040536022019040533022019022019040536022021020000020000020000010401010402010401010302010302
020000020000020000020000020000020000020000020000022118022119040533022019022019040536022019040533022019022019040536022019040533022019022019040536022019040533022019022019040536022021020000020000022118022019022019022019022019022019022019022019040533022019022019040536022019040533022019022019040536022019040533022019022019040536022021020000020000020000010401010402010401010302010302
021701020000021701020000020000020000020000020000022118022019022019022019022019022019022019022019022019022019022019022019022019022019022019022019022019022019022019022019022019022021020000020000022118022019022019022019022019022019022019022019022019022019022019022019022019022019022019022019022019022019022019022019022019022020022021020000020000020000010401010402010401010302010302
020000020000020000020000020000020000020000020000022118022019022020022020022019022020022020022020022020022020022020022020022020022020022020022020022020022020022020022020022020022021020000020000022118022020022020022020022020022020022020022020022020022020022020022020022020022020022020022020022020022020022020022020022020022020022021020000020000020000010401010402010401010302010302
021701020000021701020000020000020000020000020000022218022219022220022220022219022220022220022220022220022220022220022220022220022220022220022220022220022220022220022220022220022221020000020000022118022020022020022020022020022419022220022220022220022220022220022220022220022220022220022220022220022220022220022220022220022220022221020000020000020000010401010402010401010302010302
020000020000020000020000020000020000020000020000020000020000020000020000020000020000020000020000020000020000020000020000020000020000020000020000020000020000020000020000020000020000020000020000022118022020022020022020022020022121020000020000020000020000020000020000020000020000020000020000020000020000020000020000020000020000020000020000020000020000010401010402010401010302010302
021701020000021701020000020000020000020000020000020000020000020000020000020000020000020000020000020000020000020000020000020000020000020000020000020000020000020000020000020000020000020000020000022118022020022020022020022020022121020000020000020000020000020000020000020000020000020000020000020000020000020000020000020000020000020000020000020000020000010401010402010401010401010302
020000020000020000020000020000020000020000020000020000020000020000020000020000020000020000020000020000020000020000020000020000020000020000020000020000020000020000020000020000020000020000020000022118022020022020022020022020022121020000020000020000020000020000020000020000020000020000020000020000020000020000020000020000020000020000020000020000020000010401010402010401010401010302
021701020000021701020000021701020000021701020000021701020000021701020000021701020000021701020000021701020000021701020000021701021701021701020000021701020000021701020000021701020000021701020000022118022020022020022020022020022121021701020000021701020000021701020000021701020000021701020000021701020000021701020000021701020000021701020000021701020000010401010402010401010401010302
020000020000020000020000020000020000020000020000020000020000020000020000020000020000020000020000020000020000020000020000020000020000020000020000020000020000020000020000020000020000020000020000022118022020022020022020022020022121020000020000020000020000020000020000020000020000020000020000020000020000020000020000020000020000020000020000020000020000010401010402010401010401010302
021701020000021701020000021701020000021701020000021701020000021701020000021701020000021701020000021701020000021701021701021701020000021701020000021701020000021701020000021701020000021701020000022118022020022020022020022020022121021701020000021701020000021701020000021701021701021701020000021701020000021701020000021701020000021701020000021701020000010401010402010401010401010302
020000020000020000020000020000020000020000020000020000020000020000020000020000020000020000020000020000020000020000020000020000020000020000020000020000020000020000020000020000020000020000020000022118022020022020022020022020022121020000020000020000020000020000020000020000020000020000020000020000020000020000020000020000020000020000020000020000020000010401010402010401010401010302
