60
20
02-1-101050101050201050201050201050201050201050201050201050201050302-1-102-1-102-1-102-1-102-1-102-1-102-1-102-1-102-1-102-1-102-1-102-1-102-1-102-1-102-1-102-1-102-1-102-1-102-1-102-1-102-1-102-1-102-1-102-1-102-1-102-1-102-1-102-1-101050101050201050201050201050201050201050201050201050302-1-102-1-102-1-102-1-102-1-102-1-101040102-1-102-1-102-1-102-1-102-1-1
02-1-101060101060201060201060201060201060201060201060201060201060302-1-102-1-102-1-102-1-102-1-102-1-102-1-102-1-102-1-102-1-102-1-102-1-102-1-102-1-102-1-102-1-102-1-102-1-102-1-102-1-102-1-102-1-102-1-102-1-102-1-102-1-102-1-102-1-101060101060201060201060201060201060201060201060201060302-1-102-1-102-1-102-1-102-1-102-1-101040102-1-102-1-102-1-102-1-102-1-1
02-1-101040301040102-1-102-1-102-1-102-1-102-1-102-1-102-1-102-1-102-1-101030201050201050201050201050201050201050201050201050201050201050201050201050201050201050201050201050201050201050201050201050201050201050201050201050201050201040102-1-102-1-102-1-102-1-102-1-102-1-102-1-102-1-102-1-102-1-102-1-102-1-102-1-102-1-102-1-101040102-1-102-1-102-1-102-1-102-1-1
02-1-101040301050101050201050201050201050201050201050201050201050201050201050201060201060201060201060201060201060201060201060201060201060201060201060201060201060201060201060201060201060201060201060201060201060201060201060201060201050101050201050202-1-102-1-102-1-102-1-101040201050201050201050201050302-1-102-1-102-1-102-1-101050101050201050201050201030202-1-1
02-1-101040301060101060201060201060201060201060201060201060201060201060201060301-1-102-1-102-1-102-1-102-1-102-1-102-1-102-1-102-1-102-1-102-1-102-1-102-1-102-1-102-1-102-1-102-1-102-1-102-1-102-1-102-1-102-1-102-1-102-1-102-1-101060101060201060201050201050201050201050201050301060201060201060201060302-1-102-1-102-1-102-1-101060101060201060201050102-1-102-1-1
02-1-101040302-1-102-1-102-1-102-1-102-1-102-1-102-1-102-1-102-1-102-1-102-1-102-1-101041601041702-1-102-1-102-1-102-1-102-1-102-1-102-1-102-1-102-1-102-1-102-1-102-1-102-1-102-1-102-1-102-1-102-1-102-1-102-1-102-1-102-1-102-1-102-1-102-1-102-1-101060101060201060201060201060302-1-102-1-102-1-102-1-102-1-102-1-102-1-102-1-102-1-102-1-102-1-101050102-1-102-1-1
01050201050302-1-102-1-102-1-102-1-102-1-102-1-102-1-102-1-102-1-102-1-102-1-102-1-101051601051702-1-102-1-102-1-102-1-102-1-102-1-102-1-102-1-102-1-102-1-102-1-102-1-102-1-102-1-102-1-102-1-102-1-102-1-102-1-102-1-102-1-102-1-102-1-102-1-102-1-102-1-102-1-102-1-102-1-102-1-102-1-102-1-102-1-102-1-102-1-102-1-102-1-102-1-102-1-102-1-102-1-101040102-1-102-1-1
01060201060302-1-102-1-102-1-102-1-102-1-102-1-102-1-102-1-102-1-102-1-102-1-102-1-101061601061702-1-102-1-102-1-102-1-102-1-102-1-102-1-102-1-102-1-102-1-102-1-102-1-102-1-102-1-102-1-102-1-102-1-102-1-102-1-102-1-102-1-102-1-102-1-102-1-102-1-102-1-102-1-102-1-102-1-102-1-102-1-102-1-102-1-102-1-102-1-102-1-102-1-102-1-102-1-102-1-102-1-101040102-1-102-1-1
02-1-102-1-102-1-102-1-102-1-102-1-102-1-102-1-102-1-102-1-102-1-102-1-102-1-102-1-102-1-102-1-102-1-102-1-102-1-102-1-102-1-102-1-102-1-102-1-102-1-102-1-102-1-102-1-102-1-102-1-102-1-102-1-102-1-102-1-102-1-102-1-102-1-102-1-102-1-102-1-102-1-102-1-102-1-102-1-102-1-102-1-102-1-102-1-102-1-102-1-102-1-102-1-102-1-102-1-102-1-102-1-102-1-101040102-1-102-1-1
02-1-102-1-102-1-102-1-102-1-102-1-102-1-102-1-102-1-102-1-102-1-102-1-102-1-102-1-102-1-102-1-102-1-102-1-102-1-102-1-102-1-102-1-102-1-102-1-102-1-102-1-102-1-102-1-102-1-102-1-102-1-102-1-101041601041702-1-102-1-102-1-102-1-102-1-102-1-102-1-102-1-102-1-102-1-102-1-102-1-102-1-102-1-102-1-102-1-102-1-102-1-102-1-102-1-102-1-102-1-102-1-101040102-1-102-1-1
02-1-102-1-102-1-102-1-102-1-102-1-102-1-102-1-102-1-102-1-102-1-102-1-102-1-102-1-102-1-102-1-102-1-102-1-102-1-102-1-102-1-102-1-101020101020201020201020302-1-102-1-102-1-102-1-102-1-102-1-101051601051702-1-102-1-102-1-102-1-102-1-102-1-102-1-102-1-102-1-102-1-102-1-102-1-102-1-102-1-102-1-102-1-102-1-102-1-102-1-102-1-102-1-102-1-102-1-101040102-1-102-1-1
02-1-102-1-102-1-101020101020201020201020201020201020201020201020302-1-102-1-102-1-101020101020201020201020302-1-102-1-102-1-102-1-101030102-1-101030201030302-1-102-1-102-1-102-1-102-1-102-1-101061601061702-1-102-1-102-1-102-1-102-1-102-1-102-1-102-1-102-1-102-1-102-1-102-1-102-1-102-1-102-1-102-1-102-1-102-1-102-1-102-1-102-1-102-1-102-1-101040102-1-102-1-1
01-1-101-1-101-1-101030101030201030201030201030201030201030201030302-1-102-1-102-1-101030101030201030201030302-1-102-1-102-1-102-1-101040102-1-101030201040302-1-102-1-102-1-102-1-102-1-102-1-102-1-102-1-102-1-102-1-102-1-102-1-102-1-102-1-102-1-102-1-102-1-102-1-102-1-102-1-102-1-102-1-102-1-102-1-102-1-102-1-102-1-102-1-102-1-102-1-102-1-101050102-1-102-1-1
01020201020201020201020502-1-102-1-102-1-102-1-102-1-102-1-101040302-1-102-1-102-1-101040101040201030201040302-1-102-1-102-1-102-1-101040102-1-102-1-101040302-1-102-1-102-1-102-1-102-1-102-1-102-1-102-1-102-1-102-1-102-1-102-1-102-1-102-1-102-1-102-1-102-1-102-1-102-1-102-1-102-1-102-1-102-1-102-1-102-1-102-1-102-1-102-1-102-1-102-1-102-1-101050102-1-102-1-1
02-1-102-1-102-1-102-1-102-1-102-1-102-1-102-1-102-1-102-1-101040302-1-102-1-102-1-101050101050201050201050302-1-102-1-102-1-102-1-101040102-1-102-1-101040302-1-102-1-102-1-102-1-102-1-102-1-102-1-102-1-102-1-102-1-102-1-102-1-102-1-102-1-102-1-102-1-102-1-102-1-102-1-102-1-102-1-102-1-101-1-101020101020201020201020201020201020201020201020201020502-1-102-1-1
02-1-102-1-102-1-102-1-102-1-102-1-102-1-102-1-102-1-102-1-101040302-1-102-1-102-1-101060101060201060201060302-1-102-1-102-1-102-1-101040102-1-102-1-101040302-1-102-1-102-1-102-1-102-1-102-1-102-1-102-1-102-1-102-1-102-1-102-1-102-1-102-1-102-1-102-1-102-1-102-1-102-1-102-1-102-1-102-1-102-1-101030102-1-102-1-102-1-102-1-102-1-102-1-102-1-102-1-102-1-102-1-1
02-1-101020701021201021201021201021201021201021201020902-1-101040302-1-102-1-102-1-102-1-102-1-102-1-102-1-102-1-102-1-102-1-102-1-101040102-1-102-1-101040302-1-102-1-102-1-102-1-102-1-102-1-102-1-102-1-102-1-102-1-102-1-102-1-102-1-102-1-102-1-102-1-102-1-102-1-102-1-102-1-102-1-102-1-102-1-101040102-1-1010207010208010208010208010208010208010208010208010208
02-1-101040102-1-101020701020801020801020902-1-101040302-1-101020401020201020201020201020201020201020201020201020201020201020201020201020502-1-102-1-101020401020201020201020201020201020201020201020201020201020201020201020201020201020201020201020201020201020201020201020201020201020201020201020201020502-1-101040102-1-1010207010212010212010212010212010212010212
02-1-101040102-1-101050101050201050201050302-1-101040302-1-102-1-102-1-102-1-102-1-102-1-102-1-102-1-102-1-102-1-102-1-102-1-102-1-102-1-102-1-102-1-102-1-102-1-102-1-102-1-102-1-102-1-102-1-102-1-102-1-102-1-102-1-102-1-102-1-102-1-102-1-102-1-102-1-102-1-102-1-102-1-102-1-102-1-102-1-102-1-102-1-102-1-101040102-1-101040102-1-102-1-102-1-102-1-102-1-102-1-1
02-1-101040102-1-101060101060201060201060302-1-101040302-1-102-1-102-1-102-1-102-1-102-1-102-1-102-1-102-1-102-1-102-1-102-1-102-1-102-1-102-1-102-1-102-1-102-1-102-1-102-1-102-1-102-1-102-1-102-1-102-1-102-1-102-1-102-1-102-1-102-1-102-1-102-1-102-1-102-1-102-1-102-1-102-1-102-1-102-1-102-1-102-1-102-1-101040102-1-101040102-1-102-1-102-1-102-1-102-1-102-1-1
