60
20
010302010302010302010302010302010302010302010302010302010302010302010302010302010302010302010302010302010302010302010302010302010302010302010302010302010302010302010302010302010302010302010302010302010302010302010302010302010302010302010302010302010302010302010302010302010302010302010302010302010403020000020000020000020000010401010302010302010302010302010302
010302010303010302010302010302010302010302010302010302010302010302010302010302010302010302010302010302010302010302010302010302010302010302010302010302010302010302010302010302010302010302010302010302010302010302010302010302010302010302010302010302010302010302010302010302010302010302010302010302010403020000020000020000020000010401010302010302010302010302010302
010402010402010402010402010402010402010402010402010402010402010402010402010402010402010402010402010402010402010402010402010402010402010402010402010402010402010402010402010402010402010402010402010402010402010402010402010402010402010402010402010402010402010402010402010402010402010402010402010402010403020000020000020000020000010401010402010402010402010402010302
010302020000020000010402010402010402010402010402010402010402010402010402010402020000020000020000020000020000020000020000020000020000020000020000020000020000020000020000020000020000020000020000020000020000020000020000020000020000010402010402010402010402010402010402010402010402010402010402010402010503020000020000020000020000010501020000020000020000010302010302
010302020000020000020000020000020000020000020000020000020000020000020000020000020000020000020000020000020000020000020000020000020000020000020000020000020000020000020000020000020000020000020000020000020000020000021809021810021812020000020000010402010402010402010402010402010402020000020000020000020000020000020000020000020000020000010602020000010302010302010302
010302020000020000020000020000020000020000020000020000020000020000020000020000020000020000020000020000020000020000020000020000020000020000020000020000020000020000020000020000020000020000020000020000020000020000021909021911022210021810021810021812020000020000020000020000020000020000020000020000020000020000020000020000020000020000020000020000020000010302010302
010302020000020000020000020000020000020000020000020000020000020000020000020000020000020000020000020000020000020000020000020000020000020000020000020000020000020000020000020000020000020000020000020000020000020000022009021911021911021911021911021912020000020000020000020000020000020000020000020000020000020000020000020000020000020000020000020000020000010302010302
020000020000020000020000020000020000020000020000020000020000020000020000020000020000020000020000020000020000020000020000020000020000020000020000020000020000020000020000020000020000020000020000020000020000021809022209022310022111022111022111022112020000020000020000020000020000020000020000020000020000020000020000020000020000020000020000020000020000010302010302
020000020000020000020000020000020000020000020000020000020000020000020000020000020000020000020000020000020000020000020000020000020000020000020000020000020000020000020000020000020000020000020000020000020000022109022111022112020000020000020000020000020000020000020000020000020000020000020000020000020000020000020000020000020000020000020000020000020000010302010302
020000020000020000020000020000020000020000020000020000020000020000020000020000020000020000020000020000020000020000020000020000020000020000020000020000020000020000020000020000020000020000020000020000020000020000020000020000020000020000020000020000020000020000020000020000020000020000020000020000020000020000020000020000020000020000020000020000020000010302010302
020000020000020000020000020000020000020000020000020000020000020000020000020000020000020000020000020000020000020000020000020000020000020000020000020000020000020000020000020000020000020000020000020000020000020000020000020000020000020000020000020000020000020000020000020000020000020000020000020000020000020000020000020000020000020000020000020000020000010302010302
020000020000020000020000020000020000020000020000020000020000020000020000020000020000020000020000020000020000020000020000020000020000020000010302010302020000020000020000020000020000020000020000020000020000020000020000020000020000020000020000020000020000020000020000020000020000020000020000020000020000020000020000020000020000020000020000020000020000010302010302
020000020000020000020000020000020000020000020000020000020000020000020000020000020000020000020000020000020000020000020000020000020000010302010302010302020000020000021809021812020000020000020000020000020000020000020000020000020000020000020000020000020000020000020000020000020000020000020000020000020000020000020000020000020000020000020000020000020000010302010302
020000020000020000020000010302010302010302010302010302010302020000020000020000020000020000020000020000020000020000020000020000020000010302010302010302020000020719021909021912020719020719020000020000020000020000020000020000020000020000020000020000020000020000020000020000020000020000020000020000020000020000020000020000020000020000020000020000020000010302010302
010402010402010302010302010302010302010302010302010302010302020000020000020000020000020000020000020000020000020000020000020000020000010302010302010302020000020719021909022210021812021809021811021812020000020000020000020000020000020000020000020000020000020000021809021810021810021810021812020000020000020000020000020000020000020000020000020000020000010302010302
010402010402010402010402010402010402010402010402010402010402020000020000020000020000020000020000020000020000020000020000020000020000010302010302010302020000020719022109022309022210022209021911022012020000020000020000020000020000020000020000020000020000021809022209021911021911021911021912020000020000010302010302010302010302010302010302010302010302010302010302
010402010402010402010402010402010402010402010402010402010402020000020000020000020000020000020000020000020000020000020000020000020000010302010302010302020000020719020719022109022111022111022309022012020000020000020000020000020000020000020000020000020000022109022110022111022111022111022112020000010302010302010302010302010302010302010302010302010302010302010302
010402010402010402010402010402010402010402010402010402010402020000020000020000020000020000020000020000020000020000020000020000020000010302010302010302020000020000020000020000020000020719022109022112020000020000020000020000020000020000020000020000020000020000020000020000020000020000020000020000010302010302010302010302010302010302010302010302010302010302010302
010302010402010402010402010402010402010402010402010402010402010402010402010402010402010402010402010402010402010402010402010402010402010402010402010402010402010402010402010402010402010402010402010402010402010402010402010402010402010402010402010402010402010402010402010402010402010402010402010402010302010402010402010402010402010402010402010402010402010302010302
010302010302010302010302010302010302010302010302010302010302010302010302010302010302010302010302010302010302010302010302010302010302010302010302010302010302010302010302010302010302010302010302010302010302010302010302010302010302010302010302010302010302010302010302010302010302010302010302010302010302010302010302010302010302010302010302010302010302010302010302
