60
40
020000020000020000020000020000020000020000020000020000020000020000020000020000020000020000020000020000020000020000020000020000020000020000020000020000020000020000020000020000020000020000020000020000020000020000020000020000020000020000020000020000020000020000020000020000020000020000020000020000020000020000020000020000020000020000020000020000020000020000020000
021101020000021101020000021101020000021101020000021101020000021101020000021101020000021101020000021101020000021101020000021101020000021101020000021101021101021101020000021101020000021101020000021101020000021101020000021101020000021101020000021101021101021101020000021101020000021101020000021101021101021101021101021101020000021101020000021101020000021101020000
020000020000020000020000020000020000020000020000020000020000020000020000020000020000020000020000020000020000020000020000020000020000020000020000020000020000020000020000020000020000020000020000020000020000020000020000020000020000020000020000020000020000020000020000020000020000020000020000020000020000020000020000020000020000020000020000020000020000020000020000
021101020000021101020000021101020000021101020000021101020000021101020000021101020000021101020000021101020000021101020000021101020000021101020000021101020000021101020000021101020000021101020000021101020000021101020000021101020000021101020000021101020000021101020000021101020000021101020000021101020000021101020000021101020000021101020000021101020000021101020000
020000020000020000020000020000020000020000020000020000020000020000020000020000020000020000020000020000020000020000020000020000020000020000020000020000020000020000020000020000020000020000020000020000020000020000020000020000020000020000020000020000020000020000020000020000020000020000020000020000020000020000020000020000020000020000020000020000020000020000020000
021101020000021101020000020000020719020000020000020000020000020000020000020000020000020000020000020000020000020000020000020000020000020000020000020000020000020000020000020000020000020000020000020000020000020000020000020000020000020000020000020000020000020000020000020000020000020000020000020000020000020000020000020000020000021101020000021101020000021101020000
020000020000020000020000020000023118023120023120023120023120023120023120023120023120023120023120023120023120023120023121020719020719020719020719020719020719020918020920020920020920020920020920020920020920020920020920020920020920020920020920020920020920020920020920020920020920020920020920020921020719020000020000020000020000020000020000020000020000020000020000
021101020000021101020000020000023218023219023219023219023219023219023219023219023219023219023219023219023219023219023321020719020000020000020000020000020719021018021019021019021019021019021019021019021019021019021019021019021019021019021019021019021019021019021019021019021019021019021019021021020719020000020000020000020000021101020000021101020000021101020000
020000020000020000020000020000023218023219023219023219023219023219023219023219023219023219023219023219023219023219023321020000020000020000020000020000020719021018021120021120021120021120021120021120021120021120021120021120021120021120021120021120021120021120021120021120021120021120021120021021020719020000020000020000020000020000020000020000020000020000020000
021101020000021101020000020000023218023219023219023219023219023219023219023219023219023219023219023219023219023219023321020000020000020000020000020719020719021018021020021020021020021020021020021020021020021020021020021020021020021020021020021020021020021020021020021020021020021020021120021021020719020000020000020000020000021101020000021101020000021101020000
020000020000020000020000020000023218023219023219023219023219023219023219023219023219023219023219023219023219023219023321020000020000020000020000020719020719021018021020021020021020021020021020021020021020021020021020021020021020021020021019021019021019021019021019021020021020021020021120021021020719020000020000020000020000020000020000020000020000020000020000
021101020000021101020000020000023218023219023219023219023219023219023219023219023219023219023219023219023219023219023321020000020000020000020000020719020719021018021019021019021019021019021019021019021019021019021019021019021019021019021019021019021019021019021019021019021019021019021019021021020719020000020000020000020000021101020000021101020000021101020000
020000020000020000020000020000023218023219023219023219023219023219023219023219023219023219023219023220023219023219023321020000020000020000020000020719020719021218021219021219021219021219021219021219021219021219021219021219021219021219021219021219021219021219021219021219021219021219021219021221020719020000020000020000020000020000020000020000020000020000020000
021101020000021101020000020000023218023219023219023219023219023219023219023219023219023219023219023219023219023219023321020000020000020000020000020719020719020719020719020719020719020719020719020719020719020719020719020719020719020719020719020719020719020719020719020719020719020719020719020719020719020000020000020000020000021101020000021101020000021101020000
020000020000020000020000020719023418023419023419023419023419023419023419023419023419023419023419023419023419023419023421020000020000020000020000020719020719020719020719020719020719020719020719020719020719020719020719020719020719020719020719020719020719020719020719020719020719020719020719020719020719020000020000020000020000020000020000020000020000020000020000
021101020000021101020000020719020719020719020719020719020719020412020411020719020719020719020719020719020719020719020719020719020719020000020719020719020719020719020719020719020719020719020719020719020719020719020719020719020719020719020719020719020719020719020719020719020719020719020719020719020719020000020000020000020000021101020000021101020000021101020000
020000020000020000020000020719020719020719020719020719020719020512020719020411020719020719020719020719020719020719020719020719020719020719020719020719020719020013020014020014020014020014020014020014020014020014020014020014020016020719020719020719020719020719020719020719020719020719020719020719020719020000020000020000020000020000020000020000020000020000020000
020719020719020719020000020719020013020014020014020014020014020014020014020014020014020014020014020014020014020014020014020014020014020014020014020014020014020413020114020114020114020114020114020114020114020114020114020114020414020015020015020015020014020014020014020014020014020014020014020014020016020000020000021918021920021920021920021920021920021920021920
020000020000020719020719020000020213020114020114020114020114020114020114020114020114020114020114020114020114020114020114020114020114020114020114020114020114020214020214020214020214020214020214020214020214020214020214020214020214020214020214020214020214020214020214020214020214020214020214020214020116020000020000022018022019022019022019022019022019022019022019
020000020000020000020719020000020213020114020114020114020114020114020114020114020114020114020114020114020114020114020114020114020114020114020114020214020214020214020214020214020214020214020214020214020214020214020214020214020214020214020214020214020214020214020214020214020214020214020214020214020116020000020000022018022019022019022019022019022019022019022019
020719020719020719020719020000020213020114020114020114020114020114020114020114020114020114020114020114020114020114020114020114020114020114020114020214020214020214020214020214020214020214020214020214020214020214020214020214020214020214020214020214020214020214020214020214020214020214020214020214020116020000020000022018022019022019022019022019022019022019022019
020719020719020719020000020000020313020314020314020314020314020314020314020314020314020314020314020314020314020314020314020314020513020114020114020514020315020315020315020315020315020315020315020315020315020315020315020315020315020315020315020315020315020315020315020315020315020315020315020315020316020000020000022018022019022019022019022019022019022019022019
020000020000020000020000020000021518021519021519021519021519021519021519021519021519021519021519021519021519021519021519021521020113020114020114020216020719020719020719020719020719020719020719020719020719020719020719020719020719020719020719020719020719020719020719020719020719020719020719020719020719020000020000022218022220022220022220022220022220022220022220
021101020000021101020000020000021618021918021920021920021920021920021920021920021920021920021920021920021920021920021921021721020113020114020114020216020719020918020919020919020919020919020919020919020919020919020919020919020919020919020919020919020919020919020919020919020919020919020919020921020719020000020000020000020000021101020000021101020000021101020000
020000020000020000020000020000021618022018022019022019022019022019022019022019022019022019022019022019022019022019022021021721020113020114020114020216020719021018020922020924020924020924020924020924020924020924020924020924020924020924020924020924020924020924020924020924020924020924020925021021020719020000020000020000020000020000020000020000020000020000020000
021101020000021101020000020000021618022018022019022019022019022019022019022019022019022019022019022019022019022019022021021721020113020114020114020216020719021018021022021023021023021023021023021023021023021023021023021023021023021023021023021023021023021023021023021023021023021023021025021021020719020000020000020000020000021101020000021101020000021101020000
020000020000020000020000020000021618022018022019022019022019022019022019022019022019022019022019022019022019022019022021021721020113020114020114020216020719021018021022021023021023021023021023021023021023021023021023021023021023021023021023021023021023021023021023021023021023021023021125021021020719020000020000020000020000020000020000020000020000020000020000
021101020000021101020000020000021618022018022019022019022019022019022019022019022019022019022019022019022019022019022021021721020113020114020114020216020719021018021022021023021023021023021023021023021023021023021123021123021123021123021123021123021123021123021123021123021123021023021125021021020719020000020000020000020000021101020000021101020000021101020000
020000020000020000020000020000021618022018022020022020022020022020022020022020022020022020022020022020022020022020022021021721020113020114020114020216020719021018021022021123021123021123021123021123021123021123021123021123021123021123021123021123021123021123021123021123021123021123021125021021020719020000020000020000020000020000020000020000020000020000020000
021101020000021101020000020000021618022218022219022219022219022219022219022219022219022219022219022219022219022219022221021721020113020114020114020216020719021018021222021223021223021223021223021223021223021223021223021223021223021223021223021223021223021223021223021223021223021223021225021021020719020000020000020000020000021101020000021101020000021101020000
020000020000020000020000020000021818021819021819021819021819021819021819021819021819021819021819021819021819021819021819021821020313020314020314020316020719021218021220021220021220021220021220021220021220021220021220021220021220021220021220021220021220021220021220021220021220021220021220021221020719020000020000020000020000020000020000020000020000020000020000
021101020000021101020000020000020000020000020000020412020000020000020000020000020000020000020000020000020000020000020000020000020000020412020000020000020000020000020000020000020000020000020000020000020000020000020000020000020000020000020000020000020000020000020000020000020000020000020000020000020000020000020000020000020000021101020000021101020000021101020000
020000020000020000020000020000020000020000020000020512020000020411020511020412020000020000020411020411020000020000020511020000020411020512020000020000020000020000020000020000020000020000020000020000020000020000020000020000020000020000020000020000020000020000020000020000020000020000020000020000020000020000020000020000020000020000020000020000020000020000020000
021101020000021101020000020000020000020000020000020511020000020511020000020512020411020411020000020511020000020411020000020511020000020000020000020000020000020000020000020000020000020000020000020000020000020000020000020000020000020000020000020000020000020000020000020000020000020000020000020000020000020000020000020000020000021101020000021101020000021101020000
020000020000020000020000020000020000020000020000020000020000020000020000020000020000020000020000020000020000020000020000020000020000020000020000020000020000020000020000020000020000020000020000020000020000020000020000020000020000020000020000020000020000020000020000020000020000020000020000020000020000020000020000020000020000020000020000020000020000020000020000
021101020000021101020000021101020000021101021101021101020000021101020000021101020000021101020000021101020000021101020000021101020000021101020000021101020000021101020000021101020000021101020000021101020000021101020000021101020000021101020000021101020000021101020000021101020000021101020000021101020000021101020000021101020000021101020000021101020000021101020000
020000020000020000020000020000020000020000020000020000020000020000020000020000020000020000020000020000020000020000020000020000020000020000020000020000020000020000020000020000020000020000020000020000020000020000020000020000020000020000020000020000020000020000020000020000020000020000020000020000020000020000020000020000020000020000020000020000020000020000020000
021101020000021101020000021101020000021101020000021101020000021101020000021101020000021101020000021101020000021101020000021101020000021101020000021101021101021101021101021101020000021101020000021101020000021101020000021101020000021101020000021101020000021101020000021101020000021101020000021101020000021101020000021101020000021101020000021101020000021101020000
020000020000020000020000020000020000020000020000020000020000020000020000020000020000020000020000020000020000020000020000020000020000020000020000020000020000020000020000020000020000020000020000020000020000020000020000020000020000020000020000020000020000020000020000020000020000020000020000020000020000020000020000020000020000020000020000020000020000020000020000
021101020000021101020000021101020000021101020000021101020000021101020000021101020000021101020000021101020000021101020000021101020000021101020000021101021101021101020000021101020000021101020000021101020000021101020000021101021101021101020000021101020000021101020000021101020000021101021101021101020000021101020000021101020000021101020000021101020000021101020000
