36
30
010302010302010302010302010302010302010302010302010302010302010302010302010302010302010403020000020000020000020000020000010401010302010302010302010302010302010302010302010302010302010302010302010302010302010302010302
010302010302010302010302010302010302010302010302010302010302010302010302010302010302010403020000020000020000020000020000010401010302010302010302010302010302010302010302010302010302010302010302010302010302010302010302
010302010302010302010302010302010302010302010302010302010302010302010302010302010302010403020000020000020000020000020000010401010302010302010302010302010302010302010302010302010302010302010302010302010302010302010302
010302010302010402010403010602010602010602010602010602010602010602010602010602010602020000020000020000020000020000020000010401010402010402010402010402010402010402010402010402010402010402010402010402010402010302010302
010302010302010302010403020000020000020000020000020000020000020000020000020000020000020000020000020000020000020000020000010401010402010402010402010402010402010402010402020000020000020000020000020000010401010302010302
010302010302010302010403020000020000020000020000020000020000020000020000020000020000020000020000020000020000020000020000010401010402010402010402010402010402010402010402020000020000020000020000020000010401010302010302
010302010302010302010403020000020000020000020000020000020000020000020000020000020000020000020000020000020000020000020000010401010402010402010402010402010402010402010402020000020000020000020000020000010401010302010302
010302010302010302010403020000020000020000020000020000020000020000020000020000020000020000020000020000020000020000020000010401010402010402010402010402010402010402010402020000020000020000020000020000010401010302010302
010302010302010302010403020000020000020000020000020000020000020000020000020000020000020000020000020000020000020000020000020000020000020000020000020000020000020000020000020000020000020000020000020000010401010302010302
010302010302010302010403020000020000020000020000020000020000020000020000020000020000020000020000020000020000020000020000020000020000020000020000020000020000020000020000020000020000020000020000020000010401010302010302
010302010302010302010403020000020000020000020000020000020000020000020000020000020000020000020000020000020000020000020000020000020000020000020000020000020000020000020000020000020000020000020000020000010401010302010302
010302010302010302010403020000020000020000020000020000020000020000020000020000020000020000020000020000020000020000020000020000020000020000020000020000020000020000020000020000020000020000020000020000010401010302010302
020000020000020000020000020000020000020000020000020000020000020000020000020000020000020000020000020000020000020000020000020000020000020000020000020000020000020000020000020000020000020000020000020000010401010302010302
020000020000020000020000020000020000020000020000020000020000020000020000020000020000020000020000020000020000020000020000020000020000020000020000020000020000020000020000020000020000020000020000020000010401010302010302
020000020000020000020000020000020000020000020000020000020000020000020000020000020000020000020000020000020000020000020000020000020000020000020000020000020000020000020000020000020000020000020000020000010401010302010302
020000020000020000020000020000020000020000020000020000020000020000020000020000020000020000020000020000020000020000020000020000020000020000020000020000020000020000020000020000020000020000020000020000010401010302010302
020000020000020000020000020000020000020000020000020000020000020000020000020000082441020000020000020000020000020000020000020000020000020000020000020000020000020000020000020000020000020000020000020000010401010302010302
010302010302010302010403020000020000020000020000020000020000020000020000020000020000020000020000020000020000020000020000020000020000020000020000020000020000020000020000020000020000020000020000020000010401010302010302
010302010302010302010403020000020000020000020000020000020000020000020000020000020000020000020000020000020000020000020000020000020000020000020000020000020000020000020000020000020000020000020000020000010401010302010302
010302010302010302010403020000020000020000020000020000020000020000020000020000020000020000020000020000020000020000020000020000020000020000020000020000020000020000020000020000020000020000020000020000010401010302010302
010302010302010302010403020000020000020000020000020000020000020000020000020000020000020000020000020000020000020000020000020000020000020000020000020000020000020000020000020000020000020000020000020000010401010302010302
010302010302010302010403020000020000020000020000020000020000020000020000020000020000020000020000020000020000020000020000020000020000020000020000020000020000020000020000020000020000020000020000020000010401010302010302
010302010302010302010403020000020000020000020000020000020000020000020000020000020000020000020000020000020000020000020000020000020000020000020000020000020000020000020000020000020000020000020000020000010401010302010302
010302010302010302010403020000020000020421020421020421020421020421020421020000020000020000020000020000020000020000020000020000020000020000020000020000020000020000020000020000020000020000020000020000010401010302010302
010302010302010302010403020000020000020000020000020000020000020000020000020000020000020000020000020000020000020000020000020000020000020000020000020000020000020000020000020000020000020000020000020000010401010302010302
010302010302010302010403020000020000020000020000020000020000020000020000020000020000020000020000020000020000020000020000020000020000020000020000020000020000020000020000020000020000020000020000020000010401010302010302
010302010302010302010403020000020000020000020000020000020000020000020000020000020000020000020000020000020000020000020000020000020000020000020000020000020000020000020000020000020000020000020000020000020000010302010302
010302010302010302010302010302010302010302010302010302010302010302010302010302010302020719020000020000020000020000020000020719010302010302010302010302010302010302010302010302010302010302010302010302010302010302010302
010302010302010302010302010302010302010302010302010302010302010302010302010302010302010403020000020000020000020000020000010401010302010302010302010302010302010302010302010302010302010302010302010302010302010302010302
010302010302010302010302010302010302010302010302010302010302010302010302010302010302010403020000020000020000020000020000010401010302010302010302010302010302010302010302010302010302010302010302010302010302010302010302
