40
40
023110023110023110023110023110023110023110023110023110023110023110023110023110023110023110023110023110023110023110071415074210074115074114074114074113071415023110023110023110023110023110023110023110023110023110023110023110023110023110023110
023110023110023110023110023110023110023110023110023110023110023110023110023110023110023110023110023110023110023110071315074110074114074114074114074213071415023110023110023110023110023110023110023110023110023110023110023110023110023110023110
023110023110023110023110023110023110023110023110023110023110023110023110023110023110023110023110023110023110023110071415074210074115074114074115074113071415023110023110023110023110023110023110023110023110023110023110023110023110023110023110
023110023110023110023110023110023110023110023110023110023110023110023110023110023110023110023110023110023110023110071415074110074114074114074114074213071315023110023110023110023110023110023110023110023110023110023110023110023110023110023110
023110023110023110023110023110023110023110023110023110023110023110023110023110023110023110023110023110023110023110071415074210074114074115074114074113071415023110023110023110023110023110023110023110023110023110023110023110023110023110023110
023110023110023110023110023110023110023110023110023110023110023110023110023110023110023110023110023110023110023110071415074110074114074114074114074213071415023110023110023110023110023110023110023110023110023110023110023110023110023110023110
023110023110023110023110023110023110023110071614071415071414071615071415071414071414071415071614071615071415071415071615074210074014074014074014074113071614071615071415071415071615071315071415071415071614071415071415071615071415071415071415
023110023110023110023110023110023110023110071415071315071414071315071615071414071414071615071414071615071315071615071514074110074014074115074014074113071414071615071414071414071615071615071414071315071414071414071315071414071615071414071615
023110023110023110023110023110023110023110071614071315071315071514071315071315071415071315071315071514071315071315071315074210074014074014074014074113071315071415071315071315071315071315071415071415071315071315071514071315071415071315071315
023110023110023110023110023110023110023110071415071315074010074012074012074012074012074012074012074012074012074012074012074212074014074014074014074211074011074011074011074011074011074011074011074011074011074011074011074013071515071515071515
023110023110023110023110023110023110023110071314071315074110074014074014074014074014074014074014074014074014074014074014074014074014074115074014074014074014074014074014074014074014074014074014074014074014074014074014074213071515071415071515
023110023110023110023110023110023110023110071514071315074210074115074015074015074015074015074015074015074015074015074015074015074115074115074015074115074115074015074015074015074015074015074015074015074015074015074015074213071415071515071415
023110023110023110023110023110023110023110071415071414074110074015074015074015074115074115074015074115074015074015074015074115074115074115074115074115074115074115074115074115074115074115074115074115074115074115074115074213071315071415071515
023110023110023110023110023110023110023110071314071315074110074015074115074015074015074015074115074115074015074015074015074115074115074115074115074115074115074115074115074115074115074115074115074115074115074115074115074213071315071515071315
023110023110023110023110023110023110023110071415071315074210074015074015074115074015074115074115074115074115074115074015074115074115074115074115074115074115074115074114074115074114074114074114074114074115074115074114074213071515071315071515
023110023110023110023110023110023110023110071415071514074110074015074115074015074015074015074015074115074115074015074115074115074115074115074115074115074114074114074114074114074114074114074114074114074114074114074114074213020000020000020000
023110023110023110023110023110023110023110071314071315074110074015074015074115074015074114074115074015074015074114074114074115074115074115074115074115074115074114074114074114074114074115074114074114074114074114074114074213020000020000020000
023110023110023110023110023110023110023110071614071414074110074114074114074114074114074115074114074114074115074114074114074114074115074115074115074114074115074114074114074114074114074114074114074114074114074114074114074213020000020000020000
071315071314071415071415071314071614071415071314071614074210074114074114074115074115074115074114074115074114074114074115074114074114074115074114074114074115074114074114074115074114074114074114074114074114074114074114074213020000020000020000
074012074011074012074012074012074011074012074012074011074212074115074115074114074114074114074115074114074114074114074114074115074114074114074114074114074114074114074115074114074114074114074114074114074114074114074114074213020000020000020000
074115074015074115074114074114074015074114074015074115074115074114074114074114074115074114074114074115074114074115074114074115074114074114074114074114074114074114074114074114074114074114074114074114074114074114074114074211074012074012074012
074114074114074114074015074114074114074115074115074114074115074114074115074114074114074115074114074114074114074114074114074114074115074114074114074114074114074114074114074114074114074114074114074114074114074114074114074015074015074015074015
074114074115074114074114074114074114074114074114074015074115074114074115074115074115074115074115074115074115074115074115074115074115074115074115074115074115074115074115074115074115074115074115074115074115074115074115074015074015074015074015
074015074015074114074015074015074115074015074015074114074114074114074015074015074015074015074015074015074015074015074015074015074015074015074015074015074015074015074015074015074015074015074015074015074015074015074015074015074015074015074015
074311074311074311074311074311074311074311074311074311074311074112074015074015074015074111074312074312074312074312074312074112074015074015074015074015074015074015074015074015074015074015074015074015074015074015074015074111074311074311074311
020000020000020000020000020000020000020000020000020000020000074210074015074015074015074213020000020000020000020000020000074110074015074015074015074015074015074015074015074015074015074015074015074015074015074015074015074113020000020000020000
020000020000020000020000020000020000020000020000020000020000074110074015074015074015074213020000020000020000020000020000074110074015074015074015074015074015074015074015074015074015074015074015074015074015074015074015074113020000020000020000
020000020000020000020000020000020000020000020000020000020000074110074015074015074015074213020000020000020000020000020000074110074015074015074015074015074015074015074015074015074015074015074015074015074015074015074015074113020000020000020000
020000020000020000020000020000020000020000020000020000020000074310074311074311074311074313020000020000020000020000020000074110074015074015074015074015074015074015074015074015074015074015074015074015074015074015074015074113020000020000020000
020000020000020000020000020000020000020000020000020000020000020000020000020000020000020000020000020000020000020000020000074110074015074015074015074015074015074015074015074015074015074015074015074015074015074015074015074113020000020000020000
020000020000020000020000020000020000020000020000020000020000020000020000020000020000020000020000020000020000020000020000074110074015074015074015074015074015074015074015074015074015074015074015074015074015074015074015074213020000020000020000
020000020000020000020000020000020000020000020000020000020000020000020000020000020000020000020000020000020000020000020000074210074015074015074015074015074015074015074015074015074015074015074015074015074015074015074015074213020000020000020000
020000020000020000020000020000020000020000020000020000020000021918021920021920021920021921020000020000020000020000020000074310074311074311074311074311074311074311074311074311074311074311074311074311074311074311074311074313020000020000020000
020000020000020000020000020000020000020000020000020000020000022018022020022020022020022021020000020000020000020000020000020000020000020000020000020000020000020000021209021211021211021211021212020000020000020000020000020000020000020000020000
020000020000020000020000020000020000020000020000020000020000022018022020022020022020022021020000020000020000020000020000020000020000020000020000020000020000020000021309021311021311021311021312020000020000020000020000020000020000020000020000
020000020000020000020000020000020000020000020000020000020000022018022020022020022020022021020000020000020000020000020000020000020000020000020000020000020000020000021309021311021311021311021312020000020000020000020000020000020000020000020000
020000020000020000020000020000020000020000020000020000020000022018022020022020022020022021020000020000020000020000020000020000020000020000020000020000020000020000021309021311021311021311021312020000020000020000020000020000020000020000020000
020000020000020000020000020000020000020000020000020000020000022018022020022020022020022021020000020000020000020000020000020000020000020000020000020000020000020000021309021311021311021311021312020000020000020000020000020000020000020000020000
020000020000020000020000020000020000020000020000020000020000022018022020022020022020022021020000020000020000020000020000020000020000020000020000020000020000020000021309021311021311021311021312020000020000020000020000020000020000020000020000
020000020000020000020000020000020000020000020000020000020000022018022020022020022020022021020000020000020000020000020000020000020000020000020000020000020000020000021309021311021311021311021312020000020000020000020000020000020000020000020000
