47
40
021701021702021701021702021701021702021701021702021701021702021701021702021701021702021701021702021701021702021701021702020330020331020332020332020332020332020334021701021702021701021702021701021702021701021702021701021702021701021702021701021702021701021702021701021702021701021702
021601021602021601021602021601021602021601021602021601021602021601021602021601021602021601021602021601021602021601021602020330020331020332020332020332020332020334021601021602021601021602021601021602021601021602021601021602021601021602021601021602021601021602021601021602021601021602
021701021702021701021702021701021702021701021702021701021702021701021702021701021702021701021702021701021702021701021702020330020331020332020332020332020332020334021701021702021701021702021701021702021701021702021701021702021701021702021701021702021701021702021701021702021701021702
021601021602021601021602020728020529020529020529020529020529020529020529020529020529020529020529020529020529020529020529020530020331020332020332020332020332020334020527020528020528020528020528020528020528020529020529020529020529020529020529020529020529020727021601021602021601021602
021701021702021701021702020330024409020000020000020000020000020000020000020000020231020232020233020233020233020233020233020233020631020432020432020432020432020632020232020232020232020232020232020232020232020232020233020233020234020719020719020000020000020327021701021702021701021702
021601021602021601021602020330020000021809021810021810021810021810021812020000020331020432020432020432020432020432020432020432020432020432020432020432020432020432020432020432020432020432020432020432020432020432020432020432020334020719020719024409020000020327021601021602021601021602
021701021702021701021702020330020000021909021910022310022309021911021912020000020331020432020432020432020432020432020432020432020732020532020532020532020532020731020432020432020432020432020432020432020432020432020432020432020334020719024409020000020000020327021701021702021701021702
021601021602021601021602020330020000022009021911021912021909021911021912020000020331020432020432020432020432020432020432020433020434021601021602021601021602020331020432020432020432020432020432020432020432020432020432020432020334020719020719020000020000020327021601021602021601021602
021701021702021701021702020330020000022009022310022112022109022111022112020000020331020432020432020432020432020432020432020433020434021701021702021701021702020331020432020432020432020432020432020432020432020432020432020432020334020719020719020000020000020327021701021702021701021702
021601021602021601021602020330020000022009022012020000020000020000020000020000020331020432020432020432020432020432020432020433020434021601021602021601021602020331020432020432020432020432020432020432020432020432020432020432020334020000020719020000020000020327021601021602021601021602
021701021702021701021702020330020000022009022012020000020000020000020000020000020531020532020532020532020532020532020532020532020534021701021702021701021702020531020533020533020533020533020533020533020533020533020533020533020534020000020000024409020000020327021701021702021701021702
021601021602021601021602020330020000022109022112020000020000020000020000020000020000020000020000020000020000020000020000020000020000001928001929001930001931020719020000020000020000020000020000020000020000020000020000020000020000020000020000020000020000020327021601021602021601021602
021701021702021701021702020330020000020000020000020000020227021601021602020230020000022627020707020707020707022630020000020000022027002028002029002030002031022030020719020719020719020719022027005858005859005860005861005862022030020719021809021811021812020327021701021702021701021702
021601021602021601021602020330020000020000024409020000020327021701021702020330020000022827020707020707020707022730020000020000022127002128002129002130002131022130020719020719020719020719022127005958005959005960005961005962022230021809022209021910021912020327021601021602021601021602
021701021702021701021702020330020000020000020000020000020327021601021602020330024409022827020807020807020807022730020000020000022127002328002329002330002331022130020719020719020719020719022127006058006059006060006061006062022230022009021910021910021912020327021701021702021701021702
021601021602021601021602020330024409020000020000020000020327021701021702020330020000022827021611021611021611022730020000020000022127002428002429002430002431022130020719020719020719020719022127006258006259006260006261006262022230022009021910021910021912020327021601021602021601021602
021701021702021701021702020330020000020000020227021601021602021601021602020330020000022827022829022829022729022730020000020000022327022328022328022328022328022330020719020719020719020719022327006358006359006360006361006362022330022109022309022310022112020327021701021702021701021702
021601021602021601021602020330020000020000020427021701021702021701021702020330020000022827022829022729022729022730020000020000020000020000020000020000020000020000020000020000020000020000020000020000020000020000020000020000020000020000022009022210021812020327021601021602021601021602
021701021702021701021702020330020000020000020427021601021602021601021602020330020000022827022829023128021001021002021001021002022627022629022629022629022629022629022629022629022630020719022627022629022629022629022629022629022630020000022109022309022012020327021701021702021701021702
021601021602021601021602020330020000020000020427021701021702021701021702020330020000022827022829022730021101021102021101021102022727022829022829022829022829022829022829022829022730020719022727022829022829022829022829022829022730020000020000022109022112020327021601021602021601021602
021701021702021701021702020330020000020000020527020528020528020529020528020530020000022827022829022730021001021002021001021002022727022829022829022829022829022829022829022829022730020719022727022829022829022829022829022829022730020000020000020000020000020327021701021702021701021702
021601021602021601021602020330020000020000020000020000020000020000020000020000020000022827022829022730021101021102021101021102022727022829022829022829022829022829022829022829022730020719022727022829022829022829022829022829022730020000020000020000020000020327021601021602021601021602
021701021702021701021702020330020000024409020000020000020000020000020000020000024409022827022829022730021001021002021001021002022727022829022829022829022829022829022829022829022730020719022727022829022829022829022829022729022730020000020000020000020000020327021701021702021701021702
021601021602021601021602020330020000020000020227020228020228020228020228020230020000022827022729022730021101021102021101021102022827022829022829002015002016002017022829022829022730020719022727022829000922000923000924022829022730020000020000020000020000020327021601021602021601021602
021701021702021701021702020330020000020000020427021601021602021601021602020330020000022827022729023028022628022629022629022629023027022829002114002115002116002117002118022829022730020719022827001021001022001023001024001025022730021601021602020000020000020327021701021702021701021702
021601021602021601021602020330020000020000020427021701021702021701021702020330020000022827022729022729022729022729022729022729022829022829002214002215002216002217002218022829022830020719022827001121001122001123001124001125020227021701021702020230020000020327021601021602021601021602
021701021702021701021702020330020000020000020427021601021602021601021602020330020000022827022729022729022729022729022729022729022829022729002314002315002316002317002318022729022830020719022827001221001222001223001224001225020327021601021602020330020000020327021701021702021701021702
021601021602021601021602020330020000020000020427021701021702021701021702020330020000022827022828022829022729022729022729022829022829022729022729022729022729022729022729022729022830020719022827022729022729022729022728022728020327021701021702020330020000020327021601021602021601021602
021701021702021701021702020330020000020000020427021601021602021601021602020330020000022927022928022928022928022928022928022928023127022729022729022729022729023128022929022929022930020719022927022929022929022929022929022929020327021601021602020330020000020327021701021702021701021702
021601021602021601021602020330020000020000020427021701021702021701021702020330020000020000020000020000020000020000020000020000022727022729022729022729022729022730020000020000024409020000020000020000020000020000020000020000020327021701021702020330020000020327021601021602021601021602
021701021702021701021702020330020000020000020527020528020528020528020528020530020000020000020000020000020000024409020000020000022727022729022729022729022729022730020227021601021602021601021602021601021602021601021602021601021602021601021602020430020000020327021701021702021701021702
021601021602021601021602020330020000020000020000020000020000020000020000024409020000020000020000020000020000020000020000020000022727022729022729022729022729022730020427021701021702021701021702021701021702021701021702021701021702021701021702020430020000020327021601021602021601021602
021701021702021701021702020330020000020000024409020000020000020000020000020000020000020000020000020000020000020000020000020000022727022729022729022729022729022730020427021601021602021601021602020728020529020529020529020529020529020529020529020530020000020327021701021702021701021702
021601021602021601021602020330024409020000020000020000020000020000020000020000020000020000020000020000020000020000020000024409022727022729022729022729022729022730020427021701021702021701021702020430020000020000020000020000020000020000020000020000020000020327021601021602021601021602
021701021702021701021702020628020228020228020228020228020228020228020228020228020228020230020000024409020000020000020000020000022727022729022729022729022729022730020427021601021602021601021602020430020000020227020228020228020228020228020228020228020228020627021701021702021701021702
021601021602021601021602021601021602021601021602021601021602021601021602021601021602020330020000020000020000020000020000020000022727022729022729022729022729022730020427021701021702021701021702020430020000020427021601021602021601021602021601021602021601021602021601021602021601021602
021701021702021701021702021701021702021701021702021701021702021701021702021701021702020330020000020000020000020000020000020000022727022729022729022729022729022730020427021601021602021601021602020430020000020427021701021702021701021702021701021702021701021702021701021702021701021702
021601021602021601021602021601021602021601021602021601021602021601021602021601021602020330020000020000020707020707020707020000022727022729022729022729022729022730020427021701021702021701021702020430020000020427021601021602021601021602021601021602021601021602021601021602021601021602
021701021702021701021702021701021702021701021702021701021702021701021702021701021702020330020000020000020707020707020707020000022727022729022729022729022729022730020427021601021602021601021602020430020000020427021701021702021701021702021701021702021701021702021701021702021701021702
021601021602021601021602021601021602021601021602021601021602021601021602021601021602020330020000024409020807020807020807020719022727022729022729022729022729022730020427021701021702021701021702020430020000020427021601021602021601021602021601021602021601021602021601021602021601021602
