40
40
023301023301023301023301023301023301023301023301023301023301023301025612025613025613025615023301023301023301023301023301023301023301023301023301020000020000020000020000020000020000020000020000020000020000020000020000020000020000020000020000
023301023301023301023301023301023301023301023301023301023301023301025612025613025613025615023301023301023301023301023301023301023301023301023301020000020000020000020000020000020000020000020000020000020000020000020000020000020000020000020000
023301023301023301023301023301025613025613025613025613025613025613025613025613025613025615023301023301023301023301023301023301023301023301023301020000020000020000020000020000020000020000020000020000020000020000020000020000020000020000020000
023301023301023301023301025612021114020914020914020914020914020914020914021113025613025814023301023301023301023301023301023301023301023301023301020000020000020000020000020000020000020000020000020000020000020000020000020000020000020000020000
023301023301023301023301025612020716021209021210021210021210021210021212020913020914021113025613025615023301023301023301023301023301023301023301020000020000020000020000020000020000020000020000020000020000020000020000020000020000020000020000
023301023301023301023301025612020716021409021310021310021310021310021610021211021212020913020914020914020914020914020914020914020914021113025615020000020000020000020000020000020000020000020000020000020000020000020000020000020000020000020000
023301023301023301023301025612020716021309021310021310021310021310021310021310021610021211021211021211021211021211021211021211021212020713025615020000020000020000020000020000020000020000020000020000020000020000020000020000020000020000020000
023301023301023301023301025612020716021309021310021310021310021310021310021310021310021310021310021310021310021310021310021310021312020713025615020000020000020000020000020000020000020000020000020000020000020000020000020000020000020000020000
023301023301023301023301025612020716021409021310021310021310021310021310021310021310021310021310021310021310021310021310021310021312020713025615020000020000020000020000020000020000020000020000020000020000020000020000020000020000020000020000
023301023301023301023301025612020716021409021310021310021310021310021310021310021310021310021310021310021310021310021310021310021312020713025615020000020000020000020000020000020000020000020000020000020000020000020000020000020000020000020000
023301023301023301023301025612020716021409021310021310021310021310021310021310021310021310021310021310021310021310021310021310021312020713025615020000020000020000020000020000020000020000020000020000020000020000020000020000020000020000020000
023301023301023301023301025612020716021409021310021310021310021310021310021310021310021310021310021310021310021310021310021310021312020713025615020000020000020000020000020000020000020000020000020000020000020000020000020000020000020000020000
023301023301023301023301025612020716021409021310021310021310021310021310021310021310021310021310021310021310021310021310021310021312020713025615020000020000020000020000020000020000020000020000020000020000020000020000020000020000020000020000
023301023301023301023301025612020716021409021310021310021310021310021310021310021310021310021310021310021310021310021310021310021312020713025615020000020000020000020000020000020000020000020000020000020000020000020000020000020000020000020000
023301023301023301023301025612020716021509021510021510021709021310021310021310021310021310021310021310021310021310021310021310021312020713025615020000020000020000020000020000020000020000020000020000020000020000020000020000020000020000020000
023301023301023301023301025612021014020614020614020616021409021310021310021310021310021310021310021310021310021310021310021310021312020713025615020000020000020000020000020000020000020000020000020000020000020000020000020000020000020000020000
023301023301023301023301025712025713025713025913020716021409021310021310021310021310021310021310021310021310021310021310021310021312020713025615020000020000020000020000020000020000020000020000020000020000020000020000020000020000020000020000
023301023301023301023301023301023301023301025612020716021509021511021511021511021511021511021511021511021511021511021511021511021512020713025615020000020000020000020000020000020000020000020000020000020000020000020000020000020000020000020000
023301023301023301023301023301023301023301025612021014020614020614020614020614020614020614020614020614020614020614020614020614020614021013025615020000020000020000020000020000020000020000020000020000020000020000020000020000020000020000020000
023301023301023301023301023301023301023301025712025713025713025713025713025713025713025713025713025713025713025713025713025713025713025714025715020000020000020000020000020000020000020000020000020000020000020000020000020000020000020000020000
023301023301023301023301023301023301023301023301023301023301023301023301023301023301023301023301023301023301023301023301023301023301023301023301020000020000020000020000020000020000020000020000020000020000020000020000020000020000020000020000
023301023301023301023301023301023301023301023301023301023301023301023301023301023301023301023301023301023301023301023301023301023301023301023301020000020000020000020000020000020000020000020000020000020000020000020000020000020000020000020000
023301023301023301023301023301023301023301023301023301023301023301023301023301023301023301023301023301023301023301023301023301023301023301023301020000020000020000020000020000020000020000020000020000020000020000020000020000020000020000020000
023301023301023301023301023301023301023301023301023301023301023301023301023301023301023301023301023301023301023301023301023301023301023301023301020000020000020000020000020000020000020000020000020000020000020000020000020000020000020000020000
020000020000020000020000020000020000020000020000020000020000020000020000020000020000020000020000020000020000020000020000020000020000020000020000020000020000020000020000020000020000020000020000020000020000020000020000020000020000020000020000
020000020000020000020000020000020000020000020000020000020000020000020000020000020000020000020000020000020000020000020000020000020000020000020000020000020000020000020000020000020000020000020000020000020000020000020000020000020000020000020000
020000020000020000020000020000020000020000020000020000020000020000020000020000020000020000020000020000020000020000020000020000020000020000020000020000020000020000020000020000020000020000020000020000020000020000020000020000020000020000020000
020000020000020000020000020000020000020000020000020000020000020000020000020000020000020000020000020000020000020000020000020000020000020000020000020000020000020000020000020000020000020000020000020000020000020000020000020000020000020000020000
020000020000020000020000020000020000020000020000020000020000020000020000020000020000020000020000020000020000020000020000020000020000020000020000020000020000020000020000020000020000020000020000020000020000020000020000020000020000020000020000
020000020000020000020000020000020000020000020000020000020000020000020000020000020000020000020000020000020000020000020000020000020000020000020000020000020000020000020000020000020000020000020000020000020000020000020000020000020000020000020000
020000020000020000020000020000020000020000020000020000020000020000020000020000020000020000020000020000020000020000020000020000020000020000020000020000020000020000020000020000020000020000020000020000020000020000020000020000020000020000020000
020000020000020000020000020000020000020000020000020000020000020000020000020000020000020000020000020000020000020000020000020000020000020000020000020000020000020000020000020000020000020000020000020000020000020000020000020000020000020000020000
020000020000020000020000020000020000020000020000020000020000020000020000020000020000020000020000020000020000020000020000020000020000020000020000020000020000020000020000020000020000020000020000020000020000020000020000020000020000020000020000
020000020000020000020000020000020000020000020000020000020000020000020000020000020000020000020000020000020000020000020000020000020000020000020000020000020000020000020000020000020000020000020000020000020000020000020000020000020000020000020000
020000020000020000020000020000020000020000020000020000020000020000020000020000020000020000020000020000020000020000020000020000020000020000020000020000020000020000020000020000020000020000020000020000020000020000020000020000020000020000020000
020000020000020000020000020000020000020000020000020000020000020000020000020000020000020000020000020000020000020000020000020000020000020000020000020000020000020000020000020000020000020000020000020000020000020000020000020000020000020000020000
020000020000020000020000020000020000020000020000020000020000020000020000020000020000020000020000020000020000020000020000020000020000020000020000020000020000020000020000020000020000020000020000020000020000020000020000020000020000020000020000
020000020000020000020000020000020000020000020000020000020000020000020000020000020000020000020000020000020000020000020000020000020000020000020000020000020000020000020000020000020000020000020000020000020000020000020000020000020000020000020000
020000020000020000020000020000020000020000020000020000020000020000020000020000020000020000020000020000020000020000020000020000020000020000020000020000020000020000020000020000020000020000020000020000020000020000020000020000020000020000020000
020000020000020000020000020000020000020000020000020000020000020000020000020000020000020000020000020000020000020000020000020000020000020000020000020000020000020000020000020000020000020000020000020000020000020000020000020000020000020000020000
