40
40
025418025419023301023301023301023301023301023301023301023301023301025612025613025613025615023301023301023301023301023301023301023301023301023301020000020000020000020000020000020000020000020000020000020000020000020000020000020000020000020000
023301023314023315023301023301023301023301023301023301023301023301025612025613025613025615023301023301023301023301023314023315023301023301023301020000020000020000020000020000020000020000020000020000020000020000020000020000020000020000020000
023301023414023415023301022413022414022414022414022414022414022414022914025613025613025615023301023301023301023301023414023415023301023301023301020000020000020000020000020000020000020000020000020000020000020000020000020000020000020000020000
025314025313023301023301022513021114020914020914020914020914031105031106031107025613025814022414022416023301023301023301023301023301023301023301020000020000020000020000020000020000020000020000020000020000020000020000020000020000020000020000
025412025413023301023301025612020716021209001835001839001840021210031206020913020914021113022614022913022414022414022414022414022414022414022416020000020000020000020000020000020000020000020000020000020000020000020000020000020000020000020000
023301023314023315023301025612020716001934001935001939001940021310021610021211021212020913020914020914020914020914020914020914020914021113025615020000020000020000020000020000020000020000020000020000020000020000020000020000020000020000020000
025315023414023415023301025612020716002034002035002039002040021310021310021310021610021211021211001844001846001847021211021211021212020713025615020000020000020000020000020000020000020000020000020000020000020000020000020000020000020000020000
025419023301023301023301025612020716002134002135002139002140021310021310021310021310021310001943001944001945001947001948021310021312020713025615020000020000020000020000020000020000020000020000020000020000020000020000020000020000020000020000
023314023315023301023301025612020716002234002235002239002240021310021310021310021310002042002043002044002045002046002048002049021312020713025615020000020000020000020000020000020000020000020000020000020000020000020000020000020000020000020000
023414023415023301023301025612020716002334002335002339002340021310021310021310021310002142002143002144002145002146002147002149021312020713025615020000020000020000020000020000020000020000020000020000020000020000020000020000020000020000020000
023301023314023315023301025612020716002434002435002439002440021310021310021310021310002242002243002244002245002246002248002249021312020713025615020000020000020000020000020000020000020000020000020000020000020000020000020000020000020000020000
023301023414023415023301025612020716002534002535002535002535021310021310021310021310021310002343002344002346002347002348021310021312020028025615020000020000020000020000020000020000020000020000020000020000020000020000020000020000020000020000
023314023315023301023301025612020716021409021311021311021311021311021310021310001828021310021310021310021310021310021310021310021312020713025615020000020000020000020000020000020000020000020000020000020000020000020000020000020000020000020000
023414023415023301023301025612020716021409021311021311021311021311021310021310001928001929001930001931000408000409000410000411021312020713025615020000020000020000020000020000020000020000020000020000020000020000020000020000020000020000020000
025319023301023301023301025612020716021409021311031102021311021311021310021310002028002029002030002031000508000509000510000511021312020713025615020000020000020000020000020000020000020000020000020000020000020000020000020000020000020000020000
025419023314023315023301025612021014021509021510031202021410021310021310021310002128002129002130002131000608000609000610000611021312020713025615020000020000020000020000020000020000020000020000020000020000020000020000020000020000020000020000
023301023414023415023301025712025713025713025913025614021309021310021310021310002328002329002330002331000808000909000810000811021312020713025615020000020000020000020000020000020000020000020000020000020000020000020000020000020000020000020000
025316025317023301023301023301023301023301025612020716021509021511021511021511002428002429002430002431021511021511021511021511021512020713025615020000020000020000020000020000020000020000020000020000020000020000020000020000020000020000020000
025416025417023301023314023315023301023301025612021014020614020614020614020614020614020614020614020614020614020614020614020614020614021013025615020000020000020000020000020000020000020000020000020000020000020000020000020000020000020000020000
023314023315023301023414023415023301023301025712025713025713025713025713025713025713025713025713025713025713025713025713025713025713025714025715020000020000020000020000020000020000020000020000020000020000020000020000020000020000020000020000
023414023415025312025313023301023301023301023301023301023301023301023301023301023301023301023301023301023301023301023301023301023301023301023301020000020000020000020000020000020000020000020000020000020000020000020000020000020000020000020000
023301023301025412025413023301023301023301023301023314023315023301025318025319023301023301023314023315023301023301023314023315023314023315023301020000020000020000020000020000020000020000020000020000020000020000020000020000020000020000020000
023301023301023301023314023315023314023315023301023414023415023301025416025419023314023315023414023415023314023315023414023415023414023415023301020000020000020000020000020000020000020000020000020000020000020000020000020000020000020000020000
023301023301023301023414023415023414023415025316025319023314023315023301023301023414023415023301023301023414023415023301023301023301025314025315020000020000020000020000020000020000020000020000020000020000020000020000020000020000020000020000
020000020000020000020000020000020000020000020000020000020000020000020000020000020000020000020000020000020000020000020000020000020000020000020000020000020000020000020000020000020000020000020000020000020000020000020000020000020000020000020000
020000020000020000020000020000020000020000020000020000020000020000020000020000020000020000020000020000020000020000020000020000020000020000020000020000020000020000020000020000020000020000020000020000020000020000020000020000020000020000020000
020000020000020000020000020000020000020000020000020000020000020000020000020000020000020000020000020000020000020000020000020000020000020000020000020000020000020000020000020000020000020000020000020000020000020000020000020000020000020000020000
020000020000020000020000020000020000020000020000020000020000020000020000020000020000020000020000020000020000020000020000020000020000020000020000020000020000020000020000020000020000020000020000020000020000020000020000020000020000020000020000
020000020000020000020000020000020000020000020000020000020000020000020000020000020000020000020000020000020000020000020000020000020000020000020000020000020000020000020000020000020000020000020000020000020000020000020000020000020000020000020000
020000020000020000020000020000020000020000020000020000020000020000020000020000020000020000020000020000020000020000020000020000020000020000020000020000020000020000020000020000020000020000020000020000020000020000020000020000020000020000020000
020000020000020000020000020000020000020000020000020000020000020000020000020000020000020000020000020000020000020000020000020000020000020000020000020000020000020000020000020000020000020000020000020000020000020000020000020000020000020000020000
020000020000020000020000020000020000020000020000020000020000020000020000020000020000020000020000020000020000020000020000020000020000020000020000020000020000020000020000020000020000020000020000020000020000020000020000020000020000020000020000
020000020000020000020000020000020000020000020000020000020000020000020000020000020000020000020000020000020000020000020000020000020000020000020000020000020000020000020000020000020000020000020000020000020000020000020000020000020000020000020000
020000020000020000020000020000020000020000020000020000020000020000020000020000020000020000020000020000020000020000020000020000020000020000020000020000020000020000020000020000020000020000020000020000020000020000020000020000020000020000020000
020000020000020000020000020000020000020000020000020000020000020000020000020000020000020000020000020000020000020000020000020000020000020000020000020000020000020000020000020000020000020000020000020000020000020000020000020000020000020000020000
020000020000020000020000020000020000020000020000020000020000020000020000020000020000020000020000020000020000020000020000020000020000020000020000020000020000020000020000020000020000020000020000020000020000020000020000020000020000020000020000
020000020000020000020000020000020000020000020000020000020000020000020000020000020000020000020000020000020000020000020000020000020000020000020000020000020000020000020000020000020000020000020000020000020000020000020000020000020000020000020000
020000020000020000020000020000020000020000020000020000020000020000020000020000020000020000020000020000020000020000020000020000020000020000020000020000020000020000020000020000020000020000020000020000020000020000020000020000020000020000020000
020000020000020000020000020000020000020000020000020000020000020000020000020000020000020000020000020000020000020000020000020000020000020000020000020000020000020000020000020000020000020000020000020000020000020000020000020000020000020000020000
020000020000020000020000020000020000020000020000020000020000020000020000020000020000020000020000020000020000020000020000020000020000020000020000020000020000020000020000020000020000020000020000020000020000020000020000020000020000020000020000
