47
40
010402010403010302010403010402010403010402010402010402010403010402010402010402010402010402010402010403010402010402010402010403020000020000020000020000020000020000020000020000020000020000020000020000020000020000020000010401010402010401010402010402010402010402010402010402010402010402
010402010403010302010403010302010503010402010402010402010403010602010602010602010602010602010602010603010402010402010402010403020000020000020000020000020000020000020000020827020828020828020828020828020828020828020828010401010402010401010402010402010402010402010402010402010402010402
010402010403010302010403010402010403010402010402010302010403010402010402010402010402010402010402010402010402010402010402010403020000020000020827020828020830020000020000020927020929020929020929020929020929020929020929010401010402010501010502010502010502010502010502010502010502010502
010402010403010302010403010402010503010402010402010302010603010402010402010402010402010402010402010402010402010402010403010603020000020000020927020928021228020828020828020929020929020929020929020929020929020929020929010401010402010601010602010602010602010602010602010602010602010602
010402010403010302010403010402010403010402010402010403010308010308010308010308010308010308010308010308010308010308010403020000020000020000020927020928021028021028021028020929020929020929020929020929020929020929020929010401010402010402010402010402010402010402010402010402010402010402
010402010403010302010403010402010403010402010402010403010308010403010602010602010602012327010602010602010602010602010603020000020000020000020927020928021328021128021128021327020929020929020929020929020929020929020929010501010502010502010502010502010502010502010502010401010402010402
010402010403010302010403010402010503010402010402010403010308010403020000020000020000020000020000020000020000020000020000020000020000020000020927021028020930020000020000021127021129021129021129021129021129021129021129010601010602010602010602010602010602010602010602010401010402010402
010402010403010302010403010402010403010602010602010603010402010403020000020000020827020828020830020000020000020000020000020000020000020000020927021028020930020000020000020000020000020719020719020000020000020000020000020000020000020000020000020000020000020000020000010401010402010402
010402010403010302010403010402010503010402010402010402010402010403020000020000021027021028020930020000020000020000020000020000020000020000020927021028020930020000020000020000020000020000020000020000020000020000020000020000020000020000020000020000020000020000020000010401010402010402
010402010403010302010403010402010403010602010602010602010602010603020000020000021027021028020930020000020000020000020000020000020000020000020927020928020930020000020000020000020000020000020000020000020000020000020000020000020000020000020000020000020000020000020000010401010402010402
010402010403010302010403010402010503020000020000020000020000020000020000020000021027021028020930020000020000020000020000020000020000020000020927020928021228020829020829020829020829020829020829020829020829020829020829020829020829020829020829020829020829020830020000010401010402010402
010402010403010302010403010402010403020000020827020828020828020828020828020828021227021028020930020000020000020000020000020000020000020000020927021028021028021028021028021028021028021028021028021028021028021028021028021028021028021028021028021028021028021030020000010401010402010402
010402010403010302010403010402010403020000020927021028021328021129021129021129021129021129021130020000020000020000020000020000020000020000021127021128021128021327021028021028021028021028021028021028021028021028021028021028021028021028021028021028021028021030020000010401010402010402
010402010403010302010403010402010503020000020927021028021030020000020000020000020000020000020000020000020000020000020000020000020000020000020000020000020000021027021028021028021028021028021028021028021028021028021028021028021028021028021028021028021028021030020000010401010402010402
010402010403010302010403010402010403020000020927021028021030020000020000020000020000020000020000020000020000020000020000020000020000020000020000020000020000020927021028021028021028021028021028021028021028021028021028021028021028021028021028021028021028021030020000010401010402010402
010402010403010302010403010402010503020000020927021028021030020000020000020000020000020000020000020000020000020000020000020000020000020000020000020000020000020927021028021028021028021028021028021028021028021028021028021028021028021028021028021028021028021030020000010401010402010402
010402010403010302010403010402010603020000020927021028021030020000020000020000020000020000020000020000020000020000020000020000020000020000020000020000020000021027021028021028021028021028021028021028021028021028021028021028021028021028021028021028021028021030020000020000020000020000
020828020828020828020828020828020828020828021227021028021228020828020828020828020828020828020828020828020828020828020828020828020828020828020828020828020828021227021028021028021028021028021028021028021028021028021028021028021028021028021028021028021028021030020000020000020000020000
021028021028021028021028021028021028021028021028021028021028021028021028021028021028021028021028021028021028021028021028021028021028021028021028021028021028021028021028021028021028021028021028021028021028021028021028021028021028021028021028021028021028021030020000020000020000020000
021128021128021128021128021128021128021128021128021128021128021128021128021128021128021128021128021128021128021128021128021128021128021128021128021128021327021028021028021028021028021028021028021028021028021028021028021028021028021028021028021028021028021030020000010401010402010402
010402010403010402010403010402010403020000020000020000010301010302010302010302010302010302010302010302010302010403020000020000020000020000020000020000020927021028021028021028021028021028021028021028021028021028021028021028021028021028021028021028021028021030020000010401010402010402
010308010403010302010403010402010403020000020000010301010302010302010302010402010504010505010302010302010302010403020000020000020000020000020000020000020927021028021028021028021028021028021028021028021028021028021028021028021028021028021028021028021028021030020000010401010402010302
010402010403010302010403010402010403020000020000010401010402010402010402010402010402010302010302010302010302010403020000020000020000020000020000020000020927021028021028021028021028021028021028021028021028021028021028021028021028021028021028021028021028021030020000010401010402010302
010308010403010302010403010402010403020000020000010501010402010301010302010303010402010402010502010502010502010503020000020000020000020000020000020000020927021028021028021028021028021028021028021028021028021028021028021028021028021028021028021028021028021030020000010401010402010302
010402010403010302010403010402010403020000020000010401010402010401010302010503010402010403010602010602010602020000020000020000020000020000020000020000020927021028021028021028021028021028021028021028021028021028021028021028021028021028021028021028021028021030020000010401010402010302
010402010403010302010403010402010503020000020000010501010402010401010302010403010402010403020000020000020000020000020000020000020000020000020000020000020927021028021028021028021028021028021028021028021028021028021028021028021028021028021028021028021028021030020000010401010402010302
010308010403010402010403010402010403020000020000010501010402010402010402010503010402010403020000020000020000020000020000020000020000020000020000020000020927021028021028021028021028021028021028021028021028021028021028021028021028021028021028021028021028021030020000010401010402010302
010402010403010402010403010402010403020000020000010501010402010602010602010602010402010403020000020000020000020000020000020000020000020000020000020000020927021028021028021028021028021028021028021028021028021028021028021028021028021028021028021028021028021030020000010401010402010302
010308010403010402010403010402010403020000020000010501010402010402010402010402010402010403020000020000020000020000020000020000020000020000020000020000020927021028021028021028021028021028021028021028021028021028021028021028021028021028021028021028021028021030020000010401010402010302
010402010403010402010403010402010503020000020000010501010402010402010402010402010402010403020000020000020000020000020000020000020000020000020000020000020927021028021028021028021028021028021028021028021028021028021028021028021028021028021028021028021028021030020000010401010402010302
010308010403010402010403010402010403020000020000010601010602010602010602010602010602010503020000020000020000020000020000020000020000020000020000020000021027021029021029021029021029021029021029021029021029021029021029021029021029021029021029021029021029021030020000010401010402010302
010402010403010402010403010402010403020000020000020000020000020000020000020000020000020000020000020000020000020000020000020000020000020000020000020000021027021029021029021029021029021029021029021029021029021029021029021029021029021029021029021029021029021030020000010401010402010302
010402010403010402010403010402010403021809021810021811021811021811021812020000020000020000020000020000020000020000020000020000020000020000020000020000021127021128021128021128021128021128021128021128021128021128021128021128021128021128021128021128021128021130020000010401010402010302
010402010403010402010403010402010403021909022310022111022309021911022210021812020000020000020000020000020000020000020000020000020000020000020000020000020000020000020000020000020000020000020000020000020000020000020000020000020000020000020000020000020000020000020000010401010402010302
010308010403010402010403010402010403021909021912020719022109022309022310022112020000020000020000020000020000020000020000020000020000020000020000020000020000020000020000020000020000020000020000020000020000020000020000020000020000020000020000020000020000020000020000010401010402010302
010402010403010402010403010402010403021909022210021811021812022109022112020000020000020000020000020000020000020000020000020000020000020000020000020000020000020000020000020000020000020000020000020000020000020000020000020000020000020000020000020000020000020000020000010401010402010302
010402010403010402010403010402010503021909022010022010022210021812020000020000020000020000020000020000020000020000020000020000020000020000020000020000020000020000020000020000020000020000020000020000020000020000020000020000020000020000020000020000020000020000020000010401010402010302
010402010403010402010403010402010403022109022309022011021910021912020000020000020000020000020000020000020000020000020000020000020000020000020000020000020000020000020000020000020000020000020000020000020000020000020000020000020000020000020000020000020000020000020000010401010402010302
010402010403010402010403010402010403021809022209022310022111022112020000020000020000020000020000020000020000020000020000020000020000020000020000020000020000020000020000020000020000020000020000020000020000020000020000020000020000020000020000020000020000020000020000010401010402010302
010402010403010402010403010402010403022109022111022112020000020000020000020000020000020000020000020000020000020000020000020000020000020000020000020000020000020000020000020000020000020000020000020000020000020000020000020000020000020000020000020000020000020000020000010401010402010302
