47
40
010402010403010302010403010402010403010402010402010402010403010402010402010402010402010402010402010403010402010402010402010403020000020000020000020000020000020000020000020000001934001935001936001937001938001939001940020000010401010402010401010402010402010501010502010502010502010502
010402010403010302010403010302010503010402010402010402010403010602010602010602010602010602010602010603010402010402010402010403020000020000020000020000020000020000020000020827002034002035002036002037002038002039002040020828010401010402010401010402010402010402010402010402010302010302
010402010403010302010403010402010403010402010402010302010403010402010402010402010402010402010402010402010402010402010402010403020000020000020827020828020830020000020000020927002134002135002136002137002138002139002140020929010401010402010501010402010402010402010402010402010302010302
010402010403010302010403010402010503010402010402010302010603010402010402010402010402010402010402010402010402010402010403010603020000020000020927020928021228020828020828020929002234002235002236002237002238002239002240020929010401010402010501010502010502010502010502010502010502010502
010402010403010302010403010402010403010402010402010403010308010308010308010308010308010308010308010308010308010308010403020000020000020000020927020928021028021028021028020929002334002335002336002337002338002339002340020929010401010402010601010602010602010602010602010602010602010602
010402010403010302010403010402010403010402010402010403010308010403010602010602010602012327010602010602010602010602010603020000020000020000020927020928021328021128021128021327002434002435002436002437002438002439002440020929010401010402010402010402010402010402010402010402010302010302
010402010403010302010403010402010503010402010402010403010308010403002051002052020000020000020000002155002156002157020000020000020000020000020927021028020930020000020000021127002534002535002536002537002538002539002540021129010501010502010502010502010502010502010502010502010302010302
010402010403010302010403010402010403010602010602010603010402010403002151002152020827020828020830002255002256002257020000020000020000020000020927021028020930020000020000020000020000020719020719020000020000020000020000020000010601010602010602010602010602010602010602010401010302010302
010402010403010302010403010402010503010402010402010402010402010403002251002252021027021028020930002355002356002357020000020000020000020000020927021028020930020000020000020000020000020000020000020000020000020000020000020000020000020000020000020000020000020000020000010401010302010302
010402010403010302010403010402010403010602010602010602010602010603002351002352021027021028020930020000020000020000020000020000020000020000020927020928020930020000020000020000020000020000020000020000020000020000020000020000020000020000020000020000020000020000020000010401010302010302
010402010403010302010403010402010503020000020000020000020000020000020000020000021027021028020930020000020000020000020000020000020000020000020927020928021228020829020829020829020829020829020829020829020829020829020829020829020829020829020829020829020829020830020000010401010302010302
010402010403010302010403010402010403020000020827020828020828020828020828020828021227021028020930020000020000020000020000020000020000020000020927021028021028021028021028021028021028021028021028021028021028021028021028021028021028021028021028021028021028021030020000010401010302010302
010402010403010302010403010402010403020000020927021028021328021129021129021129021129021129021130020000020000020000020000020000020000020000021127021128021128021327021028021028021028021028021028021028021028021028021028021028021028021028021028021028021028021030020000010401010302010302
010402010403010302010403010402010503020000020927021028021030020000020000020000020000020000020000020000020000020000020000020000020000020000020000020000020000021027021028021028021028021028021028021028021028021028021028021028021028021028021028021028021028021030020000010401010302010302
010402010403010302010403010402010403020000020927021028021030020000020000020000020000020000020000020000020000020000020000020000020000020000020000020000020000020927021028021028021028021028021028021028021028021028021028021028021028021028021028021028021028021030020000010401010302010302
010402010403010302010403010402010503020000020927021028021030020000020000020000020000020000020000020000020000020000020000020000020000020000020000020000020000020927021028021028021028021028021028021028021028021028021028021028021028021028021028021028021028021030020000010501010502010502
010402010403010302010403010402010603020000020927021028021030020000020000020000020000020000020000020000020000020000020000020000020000020000020000020000020000021027021028021028021028021028021028021028021028021028021028021028021028021028021028021028021028021030020719020719010602010602
020828020828020828020828020828020828020828021227021028021228020828020828020828020828020828020828020828020828020828020828020828020828020828020828020828020828021227021028021028021028021028021028021028021028021028021028021028021028021028021028021028021028021030020719020719020719020719
021028021028021028021028021028021028021028021028021028021028021028021028021028021028021028021028021028021028021028021028021028021028021028021028021028021028021028021028000161000162021028021028021028021028021028021028021028021028021028021028021028021028021030020719020719020719020719
010202010202010202010202010202010203021128021128021128010201010202010202010202010202010202010202010202010202010203021128021128021128021128021128021128021327000259000260000261000262000263021028021028021028021028021028021028021028021028021028021028021028021030020719020719020719020719
010302010403010402010403010402010403020000020000020000010301010302010302010302010302010302010302010302010302010303020000020000020000020000020000020000020927000359000360000361000362000363021028021028021028021028021028021028021028021028021028021028021028021030020000010301010302010302
010308010403010302010403010402010403020000020000010301010302010302010302010402010504010505010302010302010302010403020000020000020000020000020000020000020927000859000560000461000462000463021028021028000166021028021028021028021028021028021028021028021028021030020000010401010302010302
010402010403010302010403010402010403020000020000010401010402010402010402010402010402010302010302010302010302010403020000020000020000020000020000020000020927000859000460000561000562000563021028000265000266000267021028021028021028021028021028021028021028021030020000010401010302010302
010308010403010302010403010402010403020000020000010501010402010301010302010303010402010402010502010502010502010503020000020000020000020000020000020000020927000859000460000661000662000663021028021028000366021028021028021028021028021028021028021028021028021030020000010401010302010302
010402010403010302010403010402010403020000020000010401010402010401010302010503010402010403010602010602010602010603020000020000020000020000020000020000020927000859000460000761000762000763021028021028000466021028021028021028021028021028021028021028021028021030020000010401010302010302
010402010403010302010403010402010503020000020000010501010402010401010302010403010402010403020000020000020000020000020000020000020000020000020000020000020927000859000560000561000562000763021028021028000566021028021028021028021028021028021028021028021028021030020000010401010302010302
010308010403010402010403010402010403020000020000010501010402010402010402010503010402010403002051002052020000020000020000020000020000020000020000020000020927000859000660000661000662000763021028021028000666021028021028021028021028021028021028021028021028021030020000010401010302010302
010402010403010402010403010402010403020000020000010501010402010602010602010602010402010403002151002152020000020000020000020000020000020000020000020000020927000859000760000761000762000763021028021028000766021028021028021028021028021028021028021028021028021030020000010401010302010302
010308010403010402010403010402010403020000020000010501010402010402010402010402010402010403002251002252020000020000020000020000020000020000020000020000020927000859021028000861000862000863021028021028000866021028021028021028021028000871021028021028021028021030020000010401010302010302
010402010403010402010403010402010503020000020000010501010402010402010402010402010402010403002351002352020000020000020000020000020000020000020000020000020927021028000960000961000962000963021028000965000966000967021028021028000970000971000972021028021028021030020000010401010302010302
010308010403010402010403010402010403020000020000010601010602010602010602010602010602010603020000020000020000020000020000020000020000020000020000020000021027001059001060001061001062001063001064001065001066001067001068001069001070001071001072001073021029021030020000010401010302010302
010402010403010402010403010402010403020000020000020000020000020000020000020000020000020000020000020000020000020000020000020000020000020000020000020000021027021029021029021029021029021029021029021029021029021029021029021029021029021029021029021029021029021030020000010401010302010302
010402010403010402010403010402010403021809021810021811021811021811021812020000020000020000020000020000020000020000020000020000020000020000020000020000021127021128021128021128021128021128021128021128021128021128021128021128021128021128021128021128021128021130020000010401010302010302
010402010403010402010403010402010403021909022310022111022309021911022210021812020000020000020000020000020000020000020000020000020000020000020000020000020000020000020000020000020000020000020000020000020000020000020000020000020000020000020000020000020000020000020000010401010302010302
010308010403010402010403010402010403021909021912020719022109022309022310022112020000020000020000020000020000020000020000020000020000020000020000020000020000020000020000020000020000020000020000020000020000020000020000020000020000020000020000020000020000020000020000010401010302010302
010402010403010402010403010402010403021909022210021811021812022109022112020000020000020000020000020000020000020000020000020000020000020000020000020000020000020000020000020000020000020000020000020000020000020000020000020000020000020000020000020000020000020000020000010401010302010302
010402010403010402010403010402010503021909022010022010022210021812020000020000020000020000020000020000020000020000020000020000020000020000020000020000020000020000020000020000020000020000020000020000020000020000020000020000020000020000020000020000020000020000020000010401010302010302
010402010403010402010403010402010403022109022309022011021910021912020000020000020000020000020000020000020000020000020000020000020000020000020000020000020000020000020000020000020000020000020000020000020000020000020000020000020000020000020000020000020000020000020000010401010302010302
010402010403010402010403010402010403021809022209022310022111022112020000020000020000020000020000020000020000020000020000020000020000020000020000020000020000020000020000020000020000020000020000020000020000020000020000020000020000020000020000020000020000020000020000010401010302010302
010402010403010402010403010402010403022109022111022112020000020000020000020000020000020000020000020000020000020000020000020000020000020000020000020000020000020000020000020000020000020000020000020000020000020000020000020000020000020000020000020000020000020000020000010401010302010302
